since feeling is first		

since feeling is first	Sadness	Sadness
who pays any attention	Sadness	Sadness
to the syntax of things	Sadness	Sadness
will never wholly kiss you;	Sadness	Sadness
wholly to be a fool	Sadness	Sadness
while Spring is in the world	Sadness	Sadness

my blood approves	Beauty / Joy	Beauty / Joy
and kisses are a better fate	Beauty / Joy	Beauty / Joy
than wisdom	Beauty / Joy	Beauty / Joy
lady i swear by all flowers.	Beauty / Joy	Beauty / Joy
Don"t cry	Beauty / Joy	Beauty / Joy
?the best gesture of my brain is less than	Beauty / Joy	Beauty / Joy
your eyelids" flutter which says	Beauty / Joy	Beauty / Joy

we are for each other: then	Beauty / Joy	Beauty / Joy
laugh, leaning back in my arms	Beauty / Joy	Beauty / Joy
for life"s not a paragraph	Beauty / Joy	Awe / Sublime --- Beauty / Joy

and death i think is no parenthesis	Sadness	Awe / Sublime --- Sadness


How Do I Love Thee? (Sonnet 43)		

How do I love thee?	Beauty / Joy --- Awe / Sublime	Beauty / Joy
Let me count the ways.	Beauty / Joy --- Awe / Sublime	Beauty / Joy
I love thee to the depth and breadth and height	Beauty / Joy --- Awe / Sublime	Beauty / Joy
My soul can reach, when feeling out of sight	Beauty / Joy --- Awe / Sublime	Beauty / Joy
For the ends of being and ideal grace.	Beauty / Joy --- Awe / Sublime	Beauty / Joy
I love thee to the level of every day"s	Beauty / Joy	Beauty / Joy
Most quiet need, by sun and candle-light.	Beauty / Joy	Beauty / Joy
I love thee freely, as men strive for right.	Beauty / Joy	Beauty / Joy
I love thee purely, as they turn from praise.	Beauty / Joy	Beauty / Joy
I love thee with the passion put to use	Beauty / Joy	Beauty / Joy
In my old griefs, and with my childhood"s faith.	Beauty / Joy	Beauty / Joy
I love thee with a love I seemed to lose	Beauty / Joy --- Awe / Sublime	Beauty / Joy --- Awe / Sublime
With my lost saints.	Beauty / Joy --- Awe / Sublime	Beauty / Joy --- Awe / Sublime
I love thee with the breath,	Beauty / Joy --- Awe / Sublime	Beauty / Joy --- Awe / Sublime
Smiles, tears, of all my life; and, if God choose,	Beauty / Joy --- Awe / Sublime	Beauty / Joy --- Awe / Sublime
I shall but love thee better after death.	Beauty / Joy --- Awe / Sublime	Beauty / Joy --- Awe / Sublime


The Good-Morrow		

I wonder, by my troth, what thou and I	Beauty / Joy	Beauty / Joy
Did, till we loved?	Beauty / Joy	Beauty / Joy
Were we not weaned till then?	Beauty / Joy	Beauty / Joy
But sucked on country pleasures, childishly?	Beauty / Joy	Beauty / Joy
Or snorted we in the Seven Sleepers? den?	Beauty / Joy	Beauty / Joy
?Twas so; but this, all pleasures fancies be.	Beauty / Joy	Beauty / Joy
If ever any beauty I did see,	Beauty / Joy	Beauty / Joy
Which I desired, and got, ?twas but a dream of thee.	Beauty / Joy	Beauty / Joy

And now good-morrow to our waking souls,	Beauty / Joy	Beauty / Joy
Which watch not one another out of fear;	Beauty / Joy	Beauty / Joy
For love, all love of other sights controls,	Beauty / Joy	Beauty / Joy
And makes one little room an everywhere.	Beauty / Joy	Beauty / Joy
Let sea-discoverers to new worlds have gone,	Vitality	Vitality
Let maps to other, worlds on worlds have shown,	Vitality	Vitality
Let us possess one world, each hath one, and is one.	Vitality	Vitality

My face in thine eye, thine in mine appears,	Beauty / Joy	Beauty / Joy
And true plain hearts do in the faces rest;	Beauty / Joy	Beauty / Joy
Where can we find two better hemispheres,	Beauty / Joy	Beauty / Joy
Without sharp north, without declining west?	Beauty / Joy	Beauty / Joy
Whatever dies, was not mixed equally;	Beauty / Joy --- Awe / Sublime	Vitality
If our two loves be one, or, thou and I	Beauty / Joy --- Awe / Sublime	Vitality
Love so alike, that none do slacken, none can die.	Beauty / Joy --- Awe / Sublime	Vitality


Happy the man		

Happy the man, and happy he alone,	Beauty / Joy --- Awe / Sublime	Awe / Sublime --- Beauty / Joy
He who can call today his own:	Beauty / Joy --- Awe / Sublime	Awe / Sublime --- Beauty / Joy
He who, secure within, can say,	Beauty / Joy --- Awe / Sublime	Awe / Sublime --- Beauty / Joy
Tomorrow do thy worst, for I have lived today.	Beauty / Joy --- Awe / Sublime	Awe / Sublime --- Beauty / Joy
Be fair or foul or rain or shine	Beauty / Joy --- Awe / Sublime	Vitality
The joys I have possessed, in spite of fate, are mine.	Beauty / Joy --- Awe / Sublime	Vitality
Not Heaven itself upon the past has power,	Beauty / Joy --- Awe / Sublime	Vitality
But what has been, has been, and I have had my hour.	Beauty / Joy --- Awe / Sublime	Vitality


ON MR . GAY		

Of Manners gentle , of Affections mild ;	Beauty / Joy --- Vitality	Suspense --- Beauty / Joy
In Wit , a Man ; Simplicity , a Child :	Beauty / Joy --- Vitality	Suspense --- Beauty / Joy
With native Humour temp"ring virtuous Rage ,	Beauty / Joy --- Vitality	Suspense --- Beauty / Joy
Form "d to delight at once and lash the age :	Beauty / Joy --- Vitality	Suspense --- Beauty / Joy
Above Temptation , in a low Estate ,	Beauty / Joy --- Vitality	Suspense --- Beauty / Joy
And uncorrupted , ev"n among the Great :	Beauty / Joy --- Vitality	Suspense --- Beauty / Joy
A safe Companion , and an easy Friend ,	Beauty / Joy --- Vitality	Suspense --- Beauty / Joy
Unblam "d thro ? Life , lamented in thy End .	Beauty / Joy --- Vitality	Suspense --- Beauty / Joy
These are Thy Honours !	Beauty / Joy --- Vitality	Suspense --- Vitality
not that here thy Bust	Beauty / Joy --- Vitality	Suspense --- Vitality
Is mix "d with Heroes , or with Kings thy dust ;	Beauty / Joy --- Vitality	Suspense --- Vitality
But that the Worthy and the Good shall say ,	Beauty / Joy --- Vitality	Suspense --- Vitality
Striking their pensive bosoms ? Here lies GAY .	Beauty / Joy --- Vitality	Suspense --- Vitality


TO ?.		

Music , when soft voices die ,	Beauty / Joy --- Sadness	Sadness
Vibrates in the memory ?	Beauty / Joy --- Sadness	Sadness
Odours , when sweet violets sicken ,	Beauty / Joy --- Sadness	Sadness
Live within the sense they quicken .	Beauty / Joy --- Sadness	Sadness

Rose leaves , when the rose is dead ,	Sadness --- Beauty / Joy	Sadness
Are heaped for the beloved "s bed ;	Sadness --- Beauty / Joy	Sadness
And so thy thoughts , when thou art gone ,	Sadness --- Beauty / Joy	Sadness
Love itself shall slumber on .	Sadness --- Beauty / Joy	Sadness


STANZAS WRITTEN IN DEJECTION , NEAR NAPLES .		

The sun is warm , the sky is clear ,	Beauty / Joy --- Vitality	Beauty / Joy --- Vitality
The waves are dancing fast and bright ,	Beauty / Joy --- Vitality	Beauty / Joy --- Vitality
Blue isles and snowy mountains wear	Beauty / Joy --- Vitality	Beauty / Joy --- Vitality
The purple noon "s transparent might ,	Beauty / Joy --- Vitality	Beauty / Joy --- Vitality
The breath of the moist earth is light ,	Beauty / Joy --- Vitality	Beauty / Joy --- Vitality
Around its unexpanded buds ;	Beauty / Joy --- Vitality	Beauty / Joy --- Vitality
Like many a voice of one delight ,	Beauty / Joy --- Vitality	Beauty / Joy --- Vitality
The winds , the birds , the ocean floods ,	Beauty / Joy --- Vitality	Beauty / Joy --- Vitality
The City "s voice itself , is soft like Solitude "s .	Beauty / Joy --- Vitality	Beauty / Joy --- Vitality

I see the Deep "s untrampled floor	Beauty / Joy	Beauty / Joy
With green and purple seaweeds strown ;	Beauty / Joy	Beauty / Joy
I see the waves upon the shore ,	Beauty / Joy	Beauty / Joy
Like light dissolved in star-showers , thrown :	Beauty / Joy	Beauty / Joy
I sit upon the sands alone ,?	Beauty / Joy	Beauty / Joy
The lightning of the noontide ocean	Beauty / Joy	Beauty / Joy
Is flashing round me , and a tone	Beauty / Joy	Beauty / Joy
Arises from its measured motion ,	Beauty / Joy	Beauty / Joy
How sweet !	Beauty / Joy	Beauty / Joy
did any heart now share in my emotion .	Beauty / Joy	Beauty / Joy

Alas !	Sadness	Sadness
I have nor hope nor health ,	Sadness	Sadness
Nor peace within nor calm around ,	Sadness	Sadness
Nor that content surpassing wealth	Sadness	Sadness
The sage in meditation found ,	Sadness	Sadness
And walked with inward glory crowned ?	Sadness	Sadness
Nor fame , nor power , nor love , nor leisure .	Sadness	Sadness
Others I see whom these surround ?	Sadness --- Annoyance	Sadness
Smiling they live , and call life pleasure ;?	Sadness --- Annoyance	Sadness
To me that cup has been dealt in another measure .	Sadness --- Annoyance	Sadness

Yet now despair itself is mild ,	Sadness	Sadness
Even as the winds and waters are ;	Sadness	Sadness
I could lie down like a tired child ,	Sadness	Sadness
And weep away the life of care	Sadness	Sadness
Which I have borne and yet must bear ,	Sadness	Sadness
Till death like sleep might steal on me ,	Sadness	Sadness
And I might feel in the warm air	Sadness	Sadness
My cheek grow cold , and hear the sea	Sadness	Sadness
Breathe o"er my dying brain its last monotony .	Sadness	Sadness

Some might lament that I were cold ,	Sadness	Sadness
As I , when this sweet day is gone ,	Sadness	Sadness
Which my lost heart , too soon grown old ,	Sadness	Sadness
Insults with this untimely moan ;	Sadness	Sadness
They might lament ? for I am one	Sadness	Sadness
Whom men love not ,? and yet regret ,	Sadness	Sadness
Unlike this day , which , when the sun	Sadness	Sadness
Shall on its stainless glory set ,	Sadness	Sadness
Will linger , though enjoyed , like joy in memory yet .	Sadness	Sadness


BREAK , BREAK , BREAK .		

Break , break , break ,	Vitality	Vitality
On thy cold gray stones , O Sea !	Vitality	Vitality
And I would that my tongue could utter	Vitality	Vitality
The thoughts that arise in me .	Vitality	Vitality

O well for the fisherman "s boy ,	Vitality	Vitality
That he shouts with his sister at play !	Vitality	Vitality
O well for the sailor lad ,	Vitality	Vitality
That he sings in his boat on the bay !	Vitality	Vitality

And the stately ships go on	Vitality	Beauty / Joy
To their haven under the hill ;	Vitality	Beauty / Joy
But O for the touch of a vanish "d hand ,	Vitality	Beauty / Joy
And the sound of a voice that is still !	Vitality	Beauty / Joy

Break , break , break ,	Vitality	Vitality --- Sadness
At the foot of thy crags , O Sea !	Vitality	Vitality --- Sadness
But the tender grace of a day that is dead	Vitality --- Sadness	Vitality --- Sadness
Will never come back to me .	Vitality --- Sadness	Vitality --- Sadness


The White Man"s Burden		

TAKE up the White Man"s burden -	Uneasiness	Vitality --- Uneasiness
Send forth the best ye breed -	Uneasiness	Vitality --- Uneasiness
Go bind your sons to exile	Uneasiness	Vitality --- Uneasiness
To serve your captives" need;	Uneasiness	Vitality --- Uneasiness
To wait in heavy harness	Uneasiness	Vitality --- Uneasiness
On fluttered folk and wild -	Uneasiness	Vitality --- Uneasiness
Your new-caught sullen peoples,	Uneasiness	Vitality --- Uneasiness
Half devil and half child.	Uneasiness	Vitality --- Uneasiness
Take up the White Man"s burden -	Uneasiness	Vitality --- Uneasiness
In patience to abide	Uneasiness	Vitality --- Uneasiness
To veil the threat of terror	Uneasiness	Vitality --- Uneasiness
And check the show of pride;	Uneasiness	Vitality --- Uneasiness
By open speech and simple,	Uneasiness	Vitality --- Uneasiness
An hundred times made plain,	Uneasiness	Vitality --- Uneasiness
To seek another"s profit,	Uneasiness	Vitality --- Uneasiness
And work another"s gain.	Uneasiness	Vitality --- Uneasiness

Take up the White Man"s burden -	Uneasiness	Vitality
The savage wars of peace -	Uneasiness	Vitality
Fill full the mouth of famine	Uneasiness	Vitality
And bid the sickness cease;	Uneasiness	Vitality
And when your goal is nearest	Uneasiness	Vitality --- Uneasiness
The end for others sought,	Uneasiness	Vitality --- Uneasiness
Watch Sloth and heathen Folly	Uneasiness	Vitality --- Uneasiness
Bring all your hopes to nought.	Uneasiness	Vitality --- Uneasiness

Take up the White Man"s burden -	Uneasiness	Vitality --- Uneasiness
No tawdry rule of kings,	Uneasiness	Vitality --- Uneasiness
But toil of serf and sweeper -	Uneasiness	Vitality --- Uneasiness
The tale of common things.	Uneasiness	Vitality --- Uneasiness
The ports ye shall not enter,	Uneasiness	Vitality --- Uneasiness
The roads ye shall not tread,	Uneasiness	Vitality --- Uneasiness
Go make them with your living,	Uneasiness	Vitality --- Uneasiness
And mark them with your dead !	Uneasiness	Vitality --- Uneasiness

Take up the White Man"s burden -	Uneasiness	Vitality --- Uneasiness
And reap his old reward,	Uneasiness	Vitality --- Uneasiness
The blame of those ye better,	Uneasiness --- Annoyance	Vitality --- Uneasiness
The hate of those ye guard -	Uneasiness --- Annoyance	Vitality --- Uneasiness
The cry of hosts ye humour	Uneasiness --- Annoyance	Vitality --- Uneasiness
(Ah slowly !)	Uneasiness --- Annoyance	Vitality --- Uneasiness
towards the light:-	Uneasiness --- Annoyance	Vitality --- Uneasiness
"Why brought ye us from bondage,	Uneasiness --- Annoyance	Vitality --- Uneasiness
"Our loved Egyptian night ?"	Uneasiness --- Annoyance	Vitality --- Uneasiness

Take up the White Man"s burden -	Sadness --- Uneasiness	Vitality --- Uneasiness
Ye dare not stoop to less -	Sadness --- Uneasiness	Vitality --- Uneasiness
Nor call too loud on Freedom	Sadness --- Uneasiness	Vitality --- Uneasiness
To cloak your weariness;	Sadness --- Uneasiness	Vitality --- Uneasiness
By all ye cry or whisper,	Sadness --- Uneasiness	Vitality --- Uneasiness
By all ye leave or do,	Sadness --- Uneasiness	Vitality --- Uneasiness
The silent sullen peoples	Sadness --- Uneasiness	Vitality --- Uneasiness
Shall weigh your Gods and you.	Sadness --- Uneasiness	Vitality --- Uneasiness

Take up the White Man"s burden -	Uneasiness --- Annoyance	Vitality --- Uneasiness
Have done with childish days -	Uneasiness --- Annoyance	Vitality --- Uneasiness
The lightly proffered laurel,	Uneasiness --- Annoyance	Vitality --- Uneasiness
The easy, ungrudged praise.	Uneasiness --- Annoyance	Vitality --- Uneasiness
Comes now, to search your manhood	Uneasiness --- Annoyance	Vitality --- Uneasiness
Through all the thankless years,	Uneasiness --- Annoyance	Vitality --- Uneasiness
Cold-edged with dear-bought wisdom,	Uneasiness --- Annoyance	Vitality --- Uneasiness
The judgement of your peers.	Uneasiness --- Annoyance	Vitality --- Uneasiness


The Way through the Woods		

They shut the road through the woods	Sadness	Suspense
Seventy years ago.	Sadness	Suspense
Weather and rain have undone it again,	Sadness --- Nostalgia	Nostalgia --- Sadness
And now you would never know	Sadness --- Nostalgia	Nostalgia --- Sadness
There was once a road through the woods	Sadness --- Nostalgia	Nostalgia --- Sadness
Before they planted the trees.	Sadness --- Nostalgia	Nostalgia --- Sadness
It is underneath the coppice and heath,	Beauty / Joy	Sadness
And the thin anemones.	Beauty / Joy	Sadness
Only the keeper sees	Beauty / Joy --- Nostalgia	Sadness --- Nostalgia
That, where the ring-dove broods,	Beauty / Joy --- Nostalgia	Sadness --- Nostalgia
And the badgers roll at ease,	Beauty / Joy --- Nostalgia	Sadness --- Nostalgia
There was once a road through the woods.	Beauty / Joy --- Nostalgia	Sadness --- Nostalgia

Yet, if you enter the woods	Beauty / Joy	Beauty / Joy
Of a summer evening late,	Beauty / Joy	Beauty / Joy
When the night-air cools on the trout-ringed pools	Beauty / Joy	Beauty / Joy
Where the otter whistles his mate,	Beauty / Joy	Beauty / Joy
(They fear not men in the woods,	Beauty / Joy	Beauty / Joy
Because they see so few.)	Beauty / Joy	Beauty / Joy
You will hear the beat of a horse?s feet,	Beauty / Joy	Nostalgia --- Beauty / Joy
And the swish of a skirt in the dew,	Beauty / Joy	Nostalgia --- Beauty / Joy
Steadily cantering through	Beauty / Joy	Nostalgia --- Beauty / Joy
The misty solitudes,	Beauty / Joy	Nostalgia --- Beauty / Joy
As though they perfectly knew	Sadness --- Nostalgia	Nostalgia --- Sadness
The old lost road through the woods.	Sadness --- Nostalgia	Nostalgia --- Sadness
But there is no road through the woods.	Sadness --- Nostalgia	Nostalgia --- Sadness


THE SICK ROSE		

O rose , thou art sick !	Sadness --- Uneasiness	Uneasiness
The invisible worm ,	Sadness --- Uneasiness	Uneasiness
That flies in the night ,	Sadness --- Uneasiness	Uneasiness
In the howling storm ,	Sadness --- Uneasiness	Uneasiness

Has found out thy bed	Sadness --- Uneasiness	Uneasiness
Of crimson joy ,	Sadness --- Uneasiness	Uneasiness
And his dark secret love	Sadness --- Uneasiness	Uneasiness
Does thy life destroy .	Sadness --- Uneasiness	Uneasiness


A POISON TREE		

I was angry with my friend :	Annoyance	Annoyance
I told my wrath , my wrath did end .	Annoyance	Annoyance
I was angry with my foe :	Annoyance	Annoyance
I told it not , my wrath did grow .	Annoyance	Annoyance

And I watered it in fears	Annoyance	Annoyance
Night and morning with my tears ,	Annoyance	Annoyance
And I sunned it with smiles	Annoyance	Annoyance
And with soft deceitful wiles .	Annoyance	Annoyance


Composed Upon Westminster Bridge, September 3, 1802		

Earth has not anything to show more fair:	Beauty / Joy --- Awe / Sublime	Beauty / Joy --- Awe / Sublime
Dull would he be of soul who could pass by	Beauty / Joy --- Awe / Sublime	Beauty / Joy --- Awe / Sublime
A sight so touching in its majesty:	Beauty / Joy --- Awe / Sublime	Beauty / Joy --- Awe / Sublime
This City now doth, like a garment, wear	Beauty / Joy	Beauty / Joy
The beauty of the morning: silent, bare,	Beauty / Joy	Beauty / Joy
Ships, towers, domes, theatres, and temples lie	Beauty / Joy	Beauty / Joy
Open unto the fields, and to the sky;	Beauty / Joy	Beauty / Joy
All bright and glittering in the smokeless air.	Beauty / Joy	Beauty / Joy
Never did sun more beautifully steep	Beauty / Joy --- Awe / Sublime	Beauty / Joy --- Awe / Sublime
In his first splendour, valley, rock, or hill;	Beauty / Joy --- Awe / Sublime	Beauty / Joy --- Awe / Sublime
Ne?er saw I, never felt, a calm so deep!	Beauty / Joy --- Awe / Sublime	Beauty / Joy --- Awe / Sublime
The river glideth at his own sweet will:	Beauty / Joy --- Awe / Sublime	Beauty / Joy --- Awe / Sublime
Dear God!	Beauty / Joy --- Awe / Sublime	Beauty / Joy --- Awe / Sublime
the very houses seem asleep;	Beauty / Joy --- Awe / Sublime	Beauty / Joy --- Awe / Sublime
And all that mighty heart is lying still!	Beauty / Joy --- Awe / Sublime	Beauty / Joy --- Awe / Sublime


The Rainbow		

My heart leaps up when I behold	Beauty / Joy	Beauty / Joy
A rainbow in the sky:	Beauty / Joy	Beauty / Joy
So was it when my life began;	Beauty / Joy --- Nostalgia	Beauty / Joy --- Nostalgia
So is it now I am a man;	Beauty / Joy --- Nostalgia	Beauty / Joy --- Nostalgia
So be it when I shall grow old,	Beauty / Joy	Vitality
Or let me die!	Beauty / Joy	Vitality
The Child is father of the Man;	Vitality --- Beauty / Joy	Vitality --- Beauty / Joy
And I could wish my days to be	Vitality --- Beauty / Joy	Vitality --- Beauty / Joy
Bound each to each by natural piety.	Vitality --- Beauty / Joy	Vitality --- Beauty / Joy


Grief		

I tell you, hopeless grief is passionless;	Sadness	Sadness
That only men incredulous of despair,	Sadness	Sadness
Half-taught in anguish, through the midnight air	Sadness	Sadness
Beat upward to God?s throne in loud access	Sadness	Sadness
Of shrieking and reproach.	Sadness	Sadness
Full desertness,	Sadness	Sadness
In souls as countries, lieth silent-bare	Sadness	Sadness
Under the blanching, vertical eye-glare	Sadness	Sadness
Of the absolute heavens.	Sadness	Sadness
Deep-hearted man, express	Sadness	Sadness
Grief for thy dead in silence like to death?	Sadness	Sadness
Most like a monumental statue set	Sadness	Sadness
In everlasting watch and moveless woe	Sadness	Sadness
Till itself crumble to the dust beneath.	Sadness	Sadness
Touch it; the marble eyelids are not wet:	Sadness	Sadness
If it could weep, it could arise and go.	Sadness	Sadness


Sonnet XXIV		

Let the world "s sharpness , like a clasping knife ,	Beauty / Joy	Beauty / Joy
Shut in upon itself and do no harm	Beauty / Joy	Beauty / Joy
In this close hand of Love , now soft and warm ,	Beauty / Joy	Beauty / Joy
And let us hear no sound of human strife	Beauty / Joy	Beauty / Joy
After the click of the shutting .	Beauty / Joy	Beauty / Joy
Life to life ?	Beauty / Joy	Beauty / Joy
I lean upon thee , Dear , without alarm ,	Beauty / Joy	Beauty / Joy
And feel as safe as guarded by a charm	Beauty / Joy	Beauty / Joy
Against the stab of worldlings , who if rife	Beauty / Joy	Beauty / Joy
Are weak to injure .	Beauty / Joy	Beauty / Joy
Very-whitely still	Beauty / Joy	Beauty / Joy
The lilies of our lives may reassure	Beauty / Joy	Beauty / Joy
Their blossoms from their roots , accessible	Beauty / Joy	Beauty / Joy
Alone to heavenly dews that drop not fewer	Beauty / Joy	Beauty / Joy
Growing straight , out of man "s reach , on the hill .	Beauty / Joy	Beauty / Joy
God only , who made us rich , can make us poor .	Awe / Sublime	Beauty / Joy --- Awe / Sublime


AH, how sweet it is to love!		

AH, how sweet it is to love!	Vitality	Beauty / Joy --- Vitality
Ah, how gay is young Desire!	Vitality	Beauty / Joy --- Vitality
And what pleasing pains we prove	Vitality	Beauty / Joy --- Vitality
When we first approach Love"s fire!	Vitality	Beauty / Joy --- Vitality
Pains of love be sweeter far	Vitality	Beauty / Joy --- Vitality
Than all other pleasures are.	Vitality	Beauty / Joy --- Vitality

Sighs which are from lovers blown	Beauty / Joy	Beauty / Joy
Do but gently heave the heart:	Beauty / Joy	Beauty / Joy
Ev"n the tears they shed alone	Beauty / Joy	Beauty / Joy
Cure, like trickling balm, their smart:	Beauty / Joy	Beauty / Joy
Lovers, when they lose their breath,	Beauty / Joy	Beauty / Joy
Bleed away in easy death.	Beauty / Joy	Beauty / Joy

Love and Time with reverence use,	Beauty / Joy --- Sadness	Beauty / Joy
Treat them like a parting friend;	Beauty / Joy --- Sadness	Beauty / Joy
Nor the golden gifts refuse	Beauty / Joy --- Sadness	Beauty / Joy
Which in youth sincere they send:	Beauty / Joy --- Sadness	Beauty / Joy
For each year their price is more,	Beauty / Joy --- Sadness	Beauty / Joy
And they less simple than before.	Beauty / Joy --- Sadness	Beauty / Joy

Love, like spring-tides full and high,	Sadness	Sadness
Swells in every youthful vein;	Sadness	Sadness
But each tide does less supply,	Sadness	Sadness
Till they quite shrink in again:	Sadness	Sadness
If a flow in age appear,	Sadness	Sadness
"Tis but rain, and runs not clear.	Sadness	Sadness


A SONG FOR ST CECILIA "S DAY		

FROM harmony , from heavenly harmony	Awe / Sublime	Beauty / Joy --- Awe / Sublime
This universal frame began :	Awe / Sublime	Beauty / Joy --- Awe / Sublime
When nature underneath a heap	Awe / Sublime	Beauty / Joy --- Awe / Sublime
Of jarring atoms lay ,	Awe / Sublime	Beauty / Joy --- Awe / Sublime
And could not heave her head ,	Awe / Sublime	Beauty / Joy --- Awe / Sublime
The tuneful voice was heard from high ,	Awe / Sublime	Beauty / Joy --- Awe / Sublime
Arise , ye more than dead .	Awe / Sublime	Beauty / Joy --- Awe / Sublime
Then cold , and hot , and moist , and dry ,	Awe / Sublime	Beauty / Joy --- Awe / Sublime
In order to their stations leap ,	Awe / Sublime	Beauty / Joy --- Awe / Sublime
And Music "s power obey .	Awe / Sublime	Beauty / Joy --- Awe / Sublime
From harmony , from heavenly harmony	Awe / Sublime	Beauty / Joy --- Awe / Sublime
This universal frame began :	Awe / Sublime	Beauty / Joy --- Awe / Sublime
From harmony to harmony	Awe / Sublime	Beauty / Joy --- Awe / Sublime
Through all the compass of the notes it rail ,	Awe / Sublime	Beauty / Joy --- Awe / Sublime
The diapason closing full in Man .	Awe / Sublime	Beauty / Joy --- Awe / Sublime

What passion cannot Music raise and quell ?	Beauty / Joy	Beauty / Joy
When Jubal struck the chorded shell ,	Suspense --- Beauty / Joy	Beauty / Joy
His listening brethren stood around ,	Suspense --- Beauty / Joy	Beauty / Joy
And , wondering , on their faces fell	Suspense --- Beauty / Joy	Beauty / Joy
To worship that celestial sound .	Suspense --- Beauty / Joy	Beauty / Joy
Less than a God they thought there could not dwell	Beauty / Joy	Beauty / Joy
Within the hollow of that shell ,	Beauty / Joy	Beauty / Joy
That spoke so sweetly and so well .	Beauty / Joy	Beauty / Joy
What passion cannot Music raise and quell ?	Beauty / Joy	Beauty / Joy

The trumpet "s loud clangour	Vitality	Uneasiness --- Vitality
Excites us to arms ,	Vitality	Uneasiness --- Vitality
With shrill notes of anger ,	Vitality --- Uneasiness	Uneasiness --- Vitality
And mortal alarms .	Vitality --- Uneasiness	Uneasiness --- Vitality
The double double double beat	Vitality --- Uneasiness	Uneasiness --- Vitality
Of the thundering drum	Vitality --- Uneasiness	Uneasiness --- Vitality
Cries , hark !	Vitality --- Uneasiness	Uneasiness --- Vitality
the foes come ;	Vitality --- Uneasiness	Uneasiness --- Vitality
Charge , charge !	Vitality --- Uneasiness	Uneasiness --- Vitality
" tis too late to retreat .	Vitality --- Uneasiness	Uneasiness --- Vitality

The soft complaining flute	Sadness	Sadness
In dying notes discovers	Sadness	Sadness
The woes of hopeless lovers ,	Sadness	Sadness
Whose dirge is whisper "d by the warbling lute .	Sadness	Sadness

Sharp violins proclaim	Uneasiness	Uneasiness
Their jealous pangs , and desperation ,	Uneasiness	Uneasiness
Fury , frantic indignation ,	Uneasiness	Uneasiness
Depth of pains , and height of passion ,	Uneasiness	Uneasiness
For the fair , disdainful dame .	Uneasiness	Uneasiness

But oh !	Beauty / Joy	Beauty / Joy --- Awe / Sublime
what art can teach ,	Beauty / Joy	Beauty / Joy --- Awe / Sublime
What human voice can reach ,	Beauty / Joy	Beauty / Joy --- Awe / Sublime
The sacred organ "s praise ?	Beauty / Joy	Beauty / Joy --- Awe / Sublime
Notes inspiring holy love ,	Awe / Sublime	Beauty / Joy --- Awe / Sublime
Notes that wing their heavenly ways	Awe / Sublime	Beauty / Joy --- Awe / Sublime
To mend the choirs above .	Awe / Sublime	Beauty / Joy --- Awe / Sublime

Orpheus could lead the savage race ;	Beauty / Joy	Beauty / Joy
And trees uprooted left their place ,	Beauty / Joy	Beauty / Joy
Sequacious of the lyre :	Beauty / Joy	Beauty / Joy
But bright Cecilia raised the wonder higher :	Beauty / Joy	Beauty / Joy --- Awe / Sublime
When to her organ vocal breath was given ,	Beauty / Joy	Beauty / Joy --- Awe / Sublime
An angel heard , and straight appear "d ,	Beauty / Joy --- Awe / Sublime	Beauty / Joy --- Awe / Sublime
Mistaking earth for heaven .	Beauty / Joy --- Awe / Sublime	Beauty / Joy --- Awe / Sublime


MUTABILITY .		

The flower that smiles to-day	Sadness	Sadness
To-morrow dies ;	Sadness	Sadness
All that we wish to stay	Sadness	Sadness
Tempts and then flies .	Sadness	Sadness
What is this world "s delight ?	Sadness	Awe / Sublime --- Sadness
Lightning that mocks the night ,	Sadness	Awe / Sublime --- Sadness
Brief even as bright .	Sadness	Awe / Sublime --- Sadness

Virtue , how frail it is !	Sadness	Sadness --- Awe / Sublime
Friendship how rare !	Sadness	Sadness --- Awe / Sublime
Love , how it sells poor bliss	Sadness	Sadness --- Awe / Sublime
For proud despair !	Sadness	Sadness --- Awe / Sublime
But we , though soon they fall ,	Sadness	Sadness
Survive their joy , and all	Sadness	Sadness
Which ours we call .	Sadness	Sadness

Whilst skies are blue and bright ,	Vitality	Vitality
Whilst flowers are gay ,	Vitality	Vitality
Whilst eyes that change ere night	Vitality	Vitality
Make glad the day ;	Vitality	Vitality
Whilst yet the calm hours creep ,	Sadness	Vitality
Dream thou ? and from thy sleep	Sadness	Vitality
Then wake to weep .	Sadness	Vitality


John Anderson , My Jo		

John Anderson , my jo , John ,	Beauty / Joy --- Nostalgia	Beauty / Joy --- Nostalgia
When we were first acquent ;	Beauty / Joy --- Nostalgia	Beauty / Joy --- Nostalgia
Your locks were like the raven ,	Beauty / Joy --- Nostalgia	Beauty / Joy --- Nostalgia
Your bonie brow was brent ;	Beauty / Joy --- Nostalgia	Beauty / Joy --- Nostalgia
But now your brow is beld , John ,	Beauty / Joy	Beauty / Joy --- Nostalgia
Your locks are like the snaw ;	Beauty / Joy	Beauty / Joy --- Nostalgia
But blessings on your frosty pow ,	Beauty / Joy	Beauty / Joy --- Nostalgia
John Anderson , my jo .	Beauty / Joy	Beauty / Joy --- Nostalgia

John Anderson , my jo , John ,	Beauty / Joy	Beauty / Joy
We clamb the hill thegither ;	Beauty / Joy	Beauty / Joy
And mony a cantie day , John ,	Beauty / Joy	Beauty / Joy
We "ve had wi ? ane anither :	Beauty / Joy	Beauty / Joy
Now we maun totter down , John ,	Beauty / Joy	Beauty / Joy
And hand in hand we "ll go ,	Beauty / Joy	Beauty / Joy
And sleep thegither at the foot ,	Beauty / Joy	Beauty / Joy
John Anderson , my jo .	Beauty / Joy	Beauty / Joy


Sonnet CXXIX		

The expense of spirit in a waste of shame	Uneasiness	Uneasiness
Is lust in action : and till action , lust	Uneasiness	Uneasiness
Is perjur "d , murderous , bloody , full of blame ,	Uneasiness	Uneasiness
Savage , extreme , rude , cruel , not to trust ;	Uneasiness	Uneasiness
Enjoy "d no sooner but despised straight ;	Uneasiness	Uneasiness
Past reason hunted ; and no sooner had ,	Uneasiness	Uneasiness
Past reason hated , as a swallow "d bait ,	Uneasiness	Uneasiness
On purpose laid to make the taker mad :	Uneasiness	Uneasiness
Mad in pursuit and in possession so ;	Sadness	Uneasiness
Had , having , and in quest , to have extreme ;	Sadness	Sadness
A bliss in proof ,? and prov "d , a very woe ;	Sadness	Sadness
Before , a joy propos "d ; behind a dream .	Sadness	Sadness
All this the world well knows ; yet none knows well	Sadness	Sadness
To shun the heaven that leads men to this hell .	Sadness	Sadness


The Passionate Pilgrim I .		

When my love swears that she is made of truth ,	Sadness	Sadness
I do believe her , though I know she lies ,	Sadness	Sadness
That she might think me some untutor "d youth ,	Sadness	Sadness
Unskilful in the world "s false forgeries ,	Sadness	Sadness
Thus vainly thinking that she thinks me young ,	Sadness	Sadness
Although I know my years be past the best ,	Sadness	Sadness
I smiling credit her false-speaking tongue ,	Sadness	Sadness
Outfacing faults in love with love "s ill rest .	Sadness	Sadness
But wherefore says my love that she is young ?	Beauty / Joy	Beauty / Joy
And wherefore say not I that I am old ?	Beauty / Joy	Beauty / Joy
O , love "s best habit is a soothing tongue ,	Beauty / Joy	Beauty / Joy
And age , in love , loves not to have years told .	Beauty / Joy	Beauty / Joy
Therefore , I "ll lie with love , and love with me ,	Beauty / Joy	Beauty / Joy
Since that our faults in love thus smother "d be .	Beauty / Joy	Beauty / Joy


Crossing the Bar		

Sunset and evening star,	Beauty / Joy	Vitality
And one clear call for me!	Beauty / Joy	Vitality
And may there be no moaning of the bar,	Beauty / Joy	Vitality
When I put out to sea,	Beauty / Joy	Vitality

But such a tide as moving seems asleep,	Beauty / Joy	Sadness
Too full for sound and foam,	Beauty / Joy	Sadness
When that which drew from out the boundless deep	Beauty / Joy	Sadness
Turns again home.	Beauty / Joy	Sadness

Twilight and evening bell,	Sadness	Vitality
And after that the dark!	Sadness	Vitality
And may there be no sadness of farewell,	Sadness	Vitality
When I embark;	Sadness	Vitality

For tho? from out our bourne of Time and Place	Beauty / Joy	Vitality
The flood may bear me far,	Beauty / Joy	Vitality
I hope to see my Pilot face to face	Beauty / Joy	Vitality
When I have crost the bar.	Beauty / Joy	Vitality


THE TYGER		

Tyger , tyger , burning bright	Beauty / Joy	Beauty / Joy
In the forests of the night ,	Beauty / Joy	Beauty / Joy
What immortal hand or eye	Beauty / Joy --- Awe / Sublime	Beauty / Joy
Could frame thy fearful symmetry ?	Beauty / Joy --- Awe / Sublime	Beauty / Joy

In what distant deeps or skies	Beauty / Joy	Beauty / Joy
Burnt the fire of thine eyes ?	Beauty / Joy	Beauty / Joy
On what wings dare he aspire ?	Beauty / Joy	Beauty / Joy
What the hand dare seize the fire ?	Beauty / Joy	Beauty / Joy

And what shoulder and what art	Uneasiness	Uneasiness
Could twist the sinews of thy heart ?	Uneasiness	Uneasiness
And , when thy heart began to beat ,	Uneasiness	Uneasiness
What dread hand and what dread feet ?	Uneasiness	Uneasiness

What the hammer ?	Uneasiness	Uneasiness
what the chain ?	Uneasiness	Uneasiness
In what furnace was thy brain ?	Uneasiness	Uneasiness
What the anvil ?	Uneasiness	Uneasiness
what dread grasp	Uneasiness	Uneasiness
Dare its deadly terrors clasp ?	Uneasiness	Uneasiness

When the stars threw down their spears ,	Awe / Sublime	Awe / Sublime
And watered heaven with their tears ,	Awe / Sublime	Awe / Sublime
Did he smile his work to see ?	Awe / Sublime	Awe / Sublime
Did he who made the lamb make thee ?	Awe / Sublime	Awe / Sublime

Tyger , tyger , burning bright	Beauty / Joy	Beauty / Joy
In the forests of the night ,	Beauty / Joy	Beauty / Joy
What immortal hand or eye	Beauty / Joy --- Awe / Sublime	Beauty / Joy --- Awe / Sublime
Dare frame thy fearful symmetry ?	Beauty / Joy --- Awe / Sublime	Beauty / Joy --- Awe / Sublime


Leda and the Swan		

A sudden blow: the great wings beating still	Suspense	Suspense --- Uneasiness
Above the staggering girl, her thighs caressed	Uneasiness	Suspense --- Uneasiness
By the dark webs, her nape caught in his bill,	Uneasiness	Suspense --- Uneasiness
He holds her helpless breast upon his breast.	Uneasiness	Suspense --- Uneasiness

How can those terrified vague fingers push	Uneasiness	Suspense --- Uneasiness
The feathered glory from her loosening thighs?	Uneasiness	Suspense --- Uneasiness
And how can body, laid in that white rush,	Uneasiness	Suspense --- Uneasiness
But feel the strange heart beating where it lies?	Uneasiness	Suspense --- Uneasiness

A shudder in the loins engenders there	Uneasiness	Uneasiness
The broken wall, the burning roof and tower	Uneasiness	Uneasiness
And Agamemnon dead.	Uneasiness	Uneasiness
Being so caught up,	Uneasiness	Uneasiness
So mastered by the brute blood of the air,	Uneasiness	Uneasiness
Did she put on his knowledge with his power	Uneasiness	Uneasiness
Before the indifferent beak could let her drop?	Uneasiness	Uneasiness


THE CHARGE OF THE LIGHT BRIGADE .		

Half a league , half a league ,	Uneasiness	Suspense --- Uneasiness
Half a league onward ,	Uneasiness	Suspense --- Uneasiness
All in the valley of Death	Uneasiness	Suspense --- Uneasiness
Rode the six hundred .	Uneasiness	Suspense --- Uneasiness
? Forward , the Light Brigade !	Uneasiness --- Suspense	Suspense --- Uneasiness
?	Uneasiness --- Suspense	Suspense --- Uneasiness
? Charge for the guns !	Uneasiness --- Suspense	Suspense --- Uneasiness
? he said :	Uneasiness --- Suspense	Suspense --- Uneasiness
Into the valley of Death	Uneasiness --- Suspense	Suspense --- Uneasiness
Rode the six hundred .	Uneasiness --- Suspense	Suspense --- Uneasiness

? Forward , the Light Brigade !	Uneasiness	Uneasiness
?	Uneasiness	Uneasiness
Was there a man dismay "d ?	Uneasiness	Uneasiness
Not tho ? the soldier knew	Uneasiness	Uneasiness
Some one had blunder "d :	Uneasiness	Uneasiness
Their "s not to make reply ,	Uneasiness	Uneasiness
Their "s not to reason why ,	Uneasiness	Uneasiness
Their "s but to do and die :	Uneasiness	Uneasiness
Into the valley of Death	Uneasiness	Uneasiness
Rode the six hundred .	Uneasiness	Uneasiness

Cannon to right of them ,	Uneasiness --- Vitality	Uneasiness
Cannon to left of them ,	Uneasiness --- Vitality	Uneasiness
Cannon in front of them	Uneasiness --- Vitality	Uneasiness
Volley "d and thunder "d ;	Uneasiness --- Vitality	Uneasiness
Storm "d at with shot and shell ,	Uneasiness --- Vitality	Uneasiness
Boldly they rode and well ,	Uneasiness	Uneasiness
Into the jaws of Death ,	Uneasiness	Uneasiness
Into the mouth of Hell	Uneasiness	Uneasiness
Rode the six hundred .	Uneasiness	Uneasiness

Flash "d all their sabres bare ,	Uneasiness	Uneasiness
Flash "d as they turn "d in air ,	Uneasiness	Uneasiness
Sabring the gunners there ,	Uneasiness	Uneasiness
Charging an army , while	Uneasiness	Uneasiness
All the world wonder "d :	Uneasiness	Uneasiness
Plunged in the battery-smoke	Uneasiness	Uneasiness
Right thro ? the line they broke ;	Uneasiness	Uneasiness
Cossack and Russian	Uneasiness	Uneasiness
Reel "d from the sabre-stroke	Uneasiness	Uneasiness
Shatter "d and sunder "d .	Uneasiness	Uneasiness
Then they rode back , but not	Uneasiness	Uneasiness
Not the six hundred .	Uneasiness	Uneasiness

Cannon to right of them ,	Uneasiness --- Vitality	Uneasiness
Cannon to left of them ,	Uneasiness --- Vitality	Uneasiness
Cannon behind them	Uneasiness --- Vitality	Uneasiness
Volley "d and thunder "d ;	Uneasiness --- Vitality	Uneasiness
Storm "d at with shot and shell ,	Uneasiness --- Vitality	Uneasiness
While horse and hero fell ,	Uneasiness	Uneasiness
They that had fought so well	Uneasiness	Uneasiness
Came thro ? the jaws of Death ,	Uneasiness	Uneasiness
Back from the mouth of Hell ,	Uneasiness	Uneasiness
All that was left of them ,	Uneasiness	Uneasiness
Left of six hundred .	Uneasiness	Uneasiness

When can their glory fade ?	Vitality	Vitality
O the wild charge they made !	Vitality	Vitality
All the world wondered .	Vitality	Vitality
Honor the charge they made !	Vitality	Vitality
Honor the Light Brigade ,	Vitality	Vitality
Noble six hundred !	Vitality	Vitality


THE MYSTERY OF PAIN .		

Pain has an element of blank ;	Sadness	Sadness
It cannot recollect	Sadness	Sadness
When it began , or if there were	Sadness	Sadness
A day when it was not .	Sadness	Sadness

It has no future but itself ,	Sadness	Sadness
Its infinite realms contain	Sadness	Sadness
Its past , enlightened to perceive	Sadness	Sadness
New periods of pain .	Sadness	Sadness


I taste a liquor never brewed		

I taste a liquor never brewed ,	Beauty / Joy --- Vitality	Beauty / Joy
From tankards scooped in pearl ;	Beauty / Joy --- Vitality	Beauty / Joy
Not all the vats upon the Rhine	Beauty / Joy --- Vitality	Beauty / Joy
Yield such an alcohol !	Beauty / Joy --- Vitality	Beauty / Joy

Inebriate of air am I ,	Beauty / Joy	Beauty / Joy --- Vitality
And debauchee of dew ,	Beauty / Joy	Beauty / Joy --- Vitality
Reeling , through endless summer days ,	Beauty / Joy	Beauty / Joy --- Vitality
From inns of molten blue .	Beauty / Joy	Beauty / Joy --- Vitality

When landlords turn the drunken bee	Beauty / Joy --- Vitality	Beauty / Joy --- Vitality
Out of the foxglove "s door ,	Beauty / Joy --- Vitality	Beauty / Joy --- Vitality
When butterflies renounce their drams ,	Beauty / Joy --- Vitality	Beauty / Joy --- Vitality
I shall but drink the more !	Beauty / Joy --- Vitality	Beauty / Joy --- Vitality

Till seraphs swing their snowy hats ,	Beauty / Joy --- Vitality	Beauty / Joy --- Vitality
And saints to windows run ,	Beauty / Joy --- Vitality	Beauty / Joy --- Vitality
To see the little tippler	Beauty / Joy --- Vitality	Beauty / Joy --- Vitality
Leaning against the sun !	Beauty / Joy --- Vitality	Beauty / Joy --- Vitality


Bright star, would I were stedfast as thou art-?		

Bright star, would I were stedfast as thou art?	Awe / Sublime	Awe / Sublime
Not in lone splendour hung aloft the night	Awe / Sublime	Awe / Sublime
And watching, with eternal lids apart,	Awe / Sublime	Awe / Sublime
Like nature?s patient, sleepless Eremite,	Awe / Sublime	Awe / Sublime
The moving waters at their priestlike task	Beauty / Joy	Awe / Sublime
Of pure ablution round earth?s human shores,	Beauty / Joy	Awe / Sublime
Or gazing on the new soft-fallen mask	Beauty / Joy	Awe / Sublime
Of snow upon the mountains and the moors?	Beauty / Joy	Awe / Sublime
No?yet still stedfast, still unchangeable,	Beauty / Joy	Vitality
Pillow?d upon my fair love?s ripening breast,	Beauty / Joy	Vitality
To feel for ever its soft fall and swell,	Beauty / Joy	Vitality
Awake for ever in a sweet unrest,	Beauty / Joy	Vitality
Still, still to hear her tender-taken breath,	Beauty / Joy	Vitality
And so live ever?or else swoon to death.	Beauty / Joy --- Sadness	Vitality


On Seeing the Elgin Marbles?		

My spirit is too weak?mortality	Sadness	Sadness
Weighs heavily on me like unwilling sleep,	Sadness	Sadness
And each imagined pinnacle and steep	Sadness	Sadness
Of godlike hardship tells me I must die	Sadness	Sadness
Like a sick eagle looking at the sky.	Sadness	Sadness
Yet ?tis a gentle luxury to weep,	Sadness	Sadness
That I have not the cloudy winds to keep,	Sadness	Sadness
Fresh for the opening of the morning?s eye.	Sadness	Sadness
Such dim-conceived glories of the brain	Sadness	Sadness
Bring round the heart an indescribable feud;	Sadness	Sadness
So do these wonders a most dizzy pain,	Sadness	Sadness
That mingles Grecian grandeur with the rude	Sadness	Sadness
Wasting of old Time?with a billowy main?	Sadness	Sadness
A sun?a shadow of a magnitude.	Sadness	Sadness


The Banks O ? Doon ? Second Version		

Ye flowery banks o ? bonie Doon ,	Beauty / Joy	Beauty / Joy
How can ye blume sae fair ?	Beauty / Joy	Beauty / Joy
How can ye chant , ye little birds ,	Beauty / Joy	Beauty / Joy
And I sae fu ? o care !	Sadness	Beauty / Joy
Thou "ll break my heart , thou bonie bird ,	Sadness	Sadness
That sings upon the bough !	Sadness	Sadness
Thou minds me o ? the happy days	Sadness --- Nostalgia	Sadness --- Nostalgia
When my fause Luve was true .	Sadness --- Nostalgia	Sadness --- Nostalgia
Thou "ll break my heart , thou bonie bird ,	Sadness	Sadness
That sings beside thy mate ;	Sadness	Sadness
For sae I sat , and sae I sang ,	Sadness	Sadness
And wist na o ? my fate .	Sadness	Sadness

Aft hae I rov "d by bonie Doon ,	Nostalgia --- Beauty / Joy	Beauty / Joy --- Nostalgia
To see the woodbine twine ;	Nostalgia --- Beauty / Joy	Beauty / Joy --- Nostalgia
And ilka bird sang o ? its Luve ,	Nostalgia --- Beauty / Joy	Beauty / Joy --- Nostalgia
And sae did I o ? mine .	Nostalgia --- Beauty / Joy	Beauty / Joy --- Nostalgia
Wi ? lightsome heart I pu "d a rose ,	Nostalgia --- Beauty / Joy	Beauty / Joy --- Nostalgia
Upon its thorny tree ;	Nostalgia --- Beauty / Joy	Beauty / Joy --- Nostalgia
But my fause Luver staw my rose ,	Sadness --- Beauty / Joy	Beauty / Joy
And left the thorn wi ? me .	Sadness --- Beauty / Joy	Beauty / Joy
Wi ? lightsome heart I pu "d a rose ,	Sadness --- Beauty / Joy	Beauty / Joy
Upon a morn in June ;	Sadness --- Beauty / Joy	Beauty / Joy
And sae I flourished on the morn ,	Sadness --- Beauty / Joy	Beauty / Joy
And sae was pu "d or noon .	Sadness --- Beauty / Joy	Beauty / Joy


A Man "s A Man For A ? That		

Is there for honest Poverty	Sadness	Vitality --- Sadness
That hings his head , an ? a ? that ;	Sadness	Vitality --- Sadness
The coward slave ? we pass him by ,	Sadness	Vitality --- Sadness
We dare be poor for a ? that !	Sadness	Vitality --- Sadness
For a ? that , an ? a ? that .	Sadness	Vitality --- Sadness
Our toils obscure an ? a ? that ,	Sadness	Vitality --- Sadness
The rank is but the guinea "s stamp ,	Sadness	Vitality --- Sadness
The Man "s the gowd for a ? that .	Sadness	Vitality --- Sadness

What though on hamely fare we dine ,	Sadness	Vitality
Wear hoddin grey , an ? a that ;	Sadness	Vitality
Gie fools their silks , and knaves their wine ;	Sadness	Vitality
A Man "s a Man for a ? that :	Sadness	Vitality
For a ? that , and a ? that ,	Sadness	Vitality
Their tinsel show , an ? a ? that ;	Sadness	Vitality
The honest man , tho ? e"er sae poor ,	Sadness	Vitality
Is king o ? men for a ? that .	Sadness	Vitality

Ye see yon birkie , ca "d a lord ,	Humor	Vitality
Wha struts , an ? stares , an ? a ? that ;	Humor	Vitality
Tho ? hundreds worship at his word ,	Humor	Vitality
He "s but a coof for a ? that :	Humor	Vitality
For a ? that , an ? a ? that ,	Humor	Vitality
His ribband , star , an ? a ? that :	Humor	Vitality
The man o ? independent mind	Humor	Vitality
He looks an ? laughs at a ? that .	Humor	Vitality

A prince can mak a belted knight ,	Beauty / Joy	Vitality
A marquis , duke , an ? a ? that ;	Beauty / Joy	Vitality
But an honest man "s abon his might ,	Beauty / Joy	Vitality
Gude faith , he maunna fa ? that !	Beauty / Joy	Vitality
For a ? that , an ? a ? that ,	Beauty / Joy	Vitality
Their dignities an ? a ? that ;	Beauty / Joy	Vitality
The pith o ? sense , an ? pride o ? worth ,	Beauty / Joy	Vitality
Are higher rank than a ? that .	Beauty / Joy	Vitality

Then let us pray that come it may ,	Beauty / Joy	Vitality --- Beauty / Joy
( As come it will for a ? that ,)	Beauty / Joy	Vitality --- Beauty / Joy
That Sense and Worth , o"er a ? the earth ,	Beauty / Joy	Vitality --- Beauty / Joy
Shall bear the gree , an ? a ? that .	Beauty / Joy	Vitality --- Beauty / Joy
For a ? that , an ? a ? that ,	Beauty / Joy	Vitality --- Beauty / Joy
It "s coming yet for a ? that ,	Beauty / Joy	Vitality --- Beauty / Joy
That Man to Man , the world o"er ,	Beauty / Joy	Vitality --- Beauty / Joy
Shall brothers be for a ? that .	Beauty / Joy	Vitality --- Beauty / Joy


Morning at the Window		

They are rattling breakfast plates in basement kitchens ,	Uneasiness	Uneasiness
And along the trampled edges of the street	Uneasiness	Uneasiness
I am aware of the damp souls of housemaids	Uneasiness	Uneasiness
Sprouting despondently at area gates .	Uneasiness	Uneasiness

The brown waves of fog toss up to me	Uneasiness	Uneasiness
Twisted faces from the bottom of the street ,	Uneasiness	Uneasiness
And tear from a passer-by with muddy skirts	Uneasiness	Uneasiness
An aimless smile that hovers in the air	Sadness --- Uneasiness	Uneasiness
And vanishes along the level of the roofs .	Sadness --- Uneasiness	Uneasiness


Preludes		

The winter evening settles down	Beauty / Joy	Beauty / Joy
With smell of steaks in passageways .	Beauty / Joy	Beauty / Joy
Six o"clock .	Beauty / Joy	Beauty / Joy
The burnt-out ends of smoky days .	Beauty / Joy	Beauty / Joy
And now a gusty shower wraps	Beauty / Joy	Beauty / Joy
The grimy scraps	Beauty / Joy	Beauty / Joy
Of withered leaves about your feet	Beauty / Joy	Beauty / Joy
And newspapers from vacant lots ;	Beauty / Joy	Beauty / Joy
The showers beat	Beauty / Joy	Beauty / Joy
On broken blinds and chimney-pots ,	Beauty / Joy	Beauty / Joy
And at the corner of the street	Beauty / Joy	Beauty / Joy
A lonely cab-horse steams and stamps .	Sadness --- Beauty / Joy	Beauty / Joy
And then the lighting of the lamps .	Beauty / Joy	Beauty / Joy

The morning comes to consciousness	Beauty / Joy	Beauty / Joy --- Vitality
Of faint stale smells of beer	Beauty / Joy	Beauty / Joy --- Vitality
From the sawdust-trampled street	Beauty / Joy	Beauty / Joy --- Vitality
With all its muddy feet that press	Beauty / Joy	Beauty / Joy --- Vitality
To early coffee-stands .	Beauty / Joy	Beauty / Joy --- Vitality
With the other masquerades	Beauty / Joy	Beauty / Joy --- Vitality
That time resumes ,	Beauty / Joy	Beauty / Joy --- Vitality
One thinks of all the hands	Beauty / Joy	Beauty / Joy --- Vitality
That are raising dingy shades	Beauty / Joy	Beauty / Joy --- Vitality
In a thousand furnished rooms .	Beauty / Joy	Beauty / Joy --- Vitality

You tossed a blanket from the bed ,	Uneasiness	Uneasiness --- Sadness
You lay upon your back , and waited ;	Uneasiness	Uneasiness --- Sadness
You dozed , and watched the night revealing	Uneasiness	Uneasiness --- Sadness
The thousand sordid images	Uneasiness	Uneasiness --- Sadness
Of which your soul was constituted ;	Uneasiness	Uneasiness --- Sadness
They flickered against the ceiling .	Sadness --- Uneasiness	Uneasiness --- Sadness
And when all the world came back	Sadness --- Uneasiness	Uneasiness --- Sadness
And the light crept up between the shutters ,	Sadness --- Uneasiness	Uneasiness --- Sadness
And you heard the sparrows in the gutters ,	Sadness --- Uneasiness	Uneasiness --- Sadness
You had such a vision of the street	Sadness --- Uneasiness	Uneasiness --- Sadness
As the street hardly understands ;	Sadness --- Uneasiness	Uneasiness --- Sadness
Sitting along the bed "s edge , where	Sadness --- Uneasiness	Sadness --- Uneasiness
You curled the papers from your hair ,	Sadness --- Uneasiness	Sadness --- Uneasiness
Or clasped the yellow soles of feet	Uneasiness	Sadness --- Uneasiness
In the palms of both soiled hands .	Uneasiness	Sadness --- Uneasiness

His soul stretched tight across the skies	Vitality	Vitality
That fade behind a city block ,	Vitality	Vitality
Or trampled by insistent feet	Vitality	Vitality
At four and five and six o"clock	Vitality	Vitality
And short square fingers stuffing pipes ,	Vitality	Vitality
And evening newspapers , and eyes	Vitality	Vitality
Assured of certain certainties ,	Vitality	Vitality
The conscience of a blackened street	Vitality	Vitality
Impatient to assume the world .	Vitality	Vitality
I am moved by fancies that are curled	Vitality	Vitality
Around these images , and cling :	Vitality	Vitality
The notion of some infinitely gentle	Awe / Sublime	Vitality --- Awe / Sublime
Infinitely suffering thing .	Awe / Sublime	Vitality --- Awe / Sublime
Wipe your hand across your mouth , and laugh ;	Beauty / Joy	Vitality --- Awe / Sublime
The worlds revolve like ancient women	Beauty / Joy	Vitality --- Awe / Sublime
Gathering fuel in vacant lots .	Beauty / Joy	Vitality --- Awe / Sublime


Death		

Nor dread nor hope attend	Sadness	Sadness
A dying animal;	Sadness	Sadness
A man awaits his end	Sadness	Sadness
Dreading and hoping all;	Sadness	Sadness
Many times he died,	Sadness	Sadness
Many times rose again,	Sadness	Sadness
A great man in his pride	Uneasiness	Sadness --- Uneasiness
Confronting murderous men	Uneasiness	Sadness --- Uneasiness
Casts derision upon	Uneasiness	Sadness --- Uneasiness
Supersession of breath;	Uneasiness	Sadness --- Uneasiness
He knows death to the bone ?	Uneasiness	Sadness --- Uneasiness
Man has created death.	Uneasiness	Sadness --- Uneasiness


The Second Coming		

Turning and turning in the widening gyre	Uneasiness	Uneasiness
The falcon cannot hear the falconer;	Uneasiness	Uneasiness
Things fall apart; the centre cannot hold;	Uneasiness	Uneasiness
Mere anarchy is loosed upon the world,	Uneasiness	Uneasiness
The blood-dimmed tide is loosed, and everywhere	Uneasiness	Uneasiness
The ceremony of innocence is drowned;	Uneasiness	Uneasiness
The best lack all conviction, while the worst	Uneasiness	Uneasiness
Are full of passionate intensity.	Uneasiness	Uneasiness

Surely some revelation is at hand;	Suspense	Suspense
Surely the Second Coming is at hand.	Suspense	Suspense
The Second Coming!	Suspense	Suspense --- Uneasiness
Hardly are those words out	Suspense	Suspense --- Uneasiness
When a vast image out of Spiritus Mundi	Suspense	Suspense --- Uneasiness
Troubles my sight: somewhere in sands of the desert	Suspense --- Uneasiness	Suspense --- Uneasiness
A shape with lion body and the head of a man,	Suspense --- Uneasiness	Suspense --- Uneasiness
A gaze blank and pitiless as the sun,	Suspense --- Uneasiness	Suspense --- Uneasiness
Is moving its slow thighs, while all about it	Suspense --- Uneasiness	Suspense --- Uneasiness
Reel shadows of the indignant desert birds.	Suspense --- Uneasiness	Suspense --- Uneasiness
The darkness drops again; but now I know	Suspense --- Uneasiness	Uneasiness
That twenty centuries of stony sleep	Suspense --- Uneasiness	Uneasiness
Were vexed to nightmare by a rocking cradle,	Suspense --- Uneasiness	Uneasiness
And what rough beast, its hour come round at last,	Suspense --- Uneasiness	Uneasiness
Slouches towards Bethlehem to be born?	Suspense --- Uneasiness	Uneasiness


An Invective against Gold .		

Of all the Poisons that the fruitful Earth	Annoyance	Annoyance
E"er yet brought forth , or Monsters she gave Birth ,	Annoyance	Annoyance
Nought to Mankind has e"er so fatal been ,	Annoyance	Annoyance
As thou , accursed Gold , their Care and Sin .	Annoyance	Annoyance

Methinks I the Advent"rous Merchant see ,	Sadness	Sadness
Ploughing the faithless Seas , in search of thee ,	Sadness	Sadness
His dearest Wife and Children left behind ,	Sadness	Sadness
( His real Wealth ) while he , a Slave to th ? Wind ,	Sadness	Sadness
Sometimes becalm "d , the Shore with longing Eyes	Sadness	Sadness
Wishes to see , and what he wishes , Spies :	Sadness	Sadness
For a rude Tempest wakes him from his Dream ,	Sadness	Sadness
And Strands his Bark by a more sad Extream .	Sadness	Sadness
Thus , hopless Wretch , is his whole Life-time spent ,	Sadness	Sadness
And though thrice Wreck"t , ? s no Wiser than he went .	Sadness	Sadness

Again , I see , the Heavenly Fair despis "d ,	Annoyance --- Sadness	Sadness --- Uneasiness
A Hagg like Hell , with Gold , more highly priz "d ;	Annoyance --- Sadness	Sadness --- Uneasiness
Mens Faith betray "d , their Prince and Country Sold ,	Annoyance --- Sadness	Sadness --- Uneasiness
Their God deny "d , all for the Idol Gold .	Annoyance --- Sadness	Sadness --- Uneasiness

Unhappy Wretch , who first found out the Oar ,	Annoyance	Uneasiness --- Annoyance
What kind of Vengeance rests for thee in store ?	Annoyance	Uneasiness --- Annoyance
If Nebats Son , that Israel led astray ,	Annoyance	Uneasiness --- Annoyance
Meet a severe Reward at the last Day ?	Annoyance	Uneasiness --- Annoyance
Some strange unheard-of Judgement thou wilt find ,	Annoyance	Uneasiness --- Annoyance
Who thus hast caus "d to Sin all Humane Kind .	Annoyance	Uneasiness --- Annoyance


Love , the Soul of Poetry .		

When first Alexis did in Verse delight ,	Beauty / Joy	Beauty / Joy
His Muse in Low , but Graceful Numbers walk"t ,	Beauty / Joy	Beauty / Joy
And now and then a little Proudly stalk"t ;	Beauty / Joy	Beauty / Joy
But never aim "d at any noble Flight :	Beauty / Joy	Beauty / Joy
The Herds , the Groves , the gentle purling Streams ,	Beauty / Joy	Beauty / Joy
Adorn "d his Song , and were his highest Theams .	Beauty / Joy	Beauty / Joy

But Love these Thoughts , like Mists , did soon disperse ,	Beauty / Joy	Beauty / Joy
Enlarg "d his Fancy , and set free his Muse ,	Beauty / Joy	Beauty / Joy
Biding him more Illustrious Subjects choose ;	Beauty / Joy	Beauty / Joy
The Acts of Gods , and God-like Men reherse .	Beauty / Joy	Beauty / Joy
From thence new Raptures did his Breast inspire ,	Beauty / Joy	Beauty / Joy
His scarce Warm-Heart converted was to Fire .	Beauty / Joy	Beauty / Joy

Th ? exalted Poet rais "d by this new Flame ,	Awe / Sublime --- Beauty / Joy	Beauty / Joy --- Awe / Sublime
With Vigor flys , where late he crept along ,	Awe / Sublime --- Beauty / Joy	Beauty / Joy --- Awe / Sublime
And Acts Divine , in a Diviner Song ,	Awe / Sublime --- Beauty / Joy	Beauty / Joy --- Awe / Sublime
Commits to the eternal Trompe of Fame .	Awe / Sublime --- Beauty / Joy	Beauty / Joy --- Awe / Sublime
And thus Alexis does prove Love to be ,	Awe / Sublime --- Beauty / Joy	Beauty / Joy --- Awe / Sublime
As the Worlds Soul , the Soul of Poetry .	Awe / Sublime --- Beauty / Joy	Beauty / Joy --- Awe / Sublime


SUCCESS		

Success is counted sweetest	Beauty / Joy	Beauty / Joy
By those who ne"er succeed .	Beauty / Joy	Beauty / Joy
To comprehend a nectar	Beauty / Joy	Beauty / Joy
Requires sorest need .	Beauty / Joy	Beauty / Joy

Not one of all the purple host	Sadness	Sadness
Who took the flag to-day	Sadness	Sadness
Can tell the definition ,	Sadness	Sadness
So clear , of victory ,	Sadness	Sadness

As he , defeated , dying ,	Sadness	Sadness
On whose forbidden ear	Sadness	Sadness
The distant strains of triumph	Sadness	Sadness
Break , agonized and clear !	Sadness	Sadness


I felt a funeral in my brain		

I felt a funeral in my brain ,	Sadness	Sadness
And mourners , to and fro ,	Sadness	Sadness
Kept treading , treading , till it seemed	Sadness --- Awe / Sublime	Sadness
That sense was breaking through .	Sadness --- Awe / Sublime	Sadness

And when they all were seated ,	Sadness	Sadness
A service like a drum	Sadness	Sadness
Kept beating , beating , till I thought	Sadness	Sadness
My mind was going numb .	Sadness	Sadness

And then I heard them lift a box ,	Sadness	Sadness
And creak across my soul	Sadness	Sadness
With those same boots of lead , again .	Sadness	Sadness
Then space began to toll	Sadness	Sadness

As all the heavens were a bell ,	Awe / Sublime	Sadness --- Awe / Sublime
And Being but an ear ,	Awe / Sublime	Sadness --- Awe / Sublime
And I and silence some strange race ,	Awe / Sublime --- Sadness	Sadness --- Awe / Sublime
Wrecked , solitary , here .	Awe / Sublime --- Sadness	Sadness --- Awe / Sublime

And then a Plank in Reason, broke,	Awe / Sublime	Sadness --- Awe / Sublime
And I dropped down, and down -	Awe / Sublime	Sadness --- Awe / Sublime
And hit a World, at every plunge,	Awe / Sublime	Sadness --- Awe / Sublime
And Finished knowing - then -	Awe / Sublime	Sadness --- Awe / Sublime


On His Blindness		

WHEN I consider how my light is spent	Suspense	Sadness --- Suspense
Ere half my days in this dark world and wide,	Suspense	Sadness --- Suspense
And that one Talent which is death to hide	Sadness	Sadness --- Suspense
Lodged with me useless, though my soul more bent	Sadness	Sadness --- Suspense

To serve therewith my Maker, and present	Vitality	Vitality
My true account, lest He returning chide,	Vitality	Vitality
?Doth God exact day-labour, light denied??	Vitality	Vitality
I fondly ask.	Vitality	Vitality
But Patience, to prevent	Vitality	Vitality

That murmur, soon replies, ?God doth not need	Awe / Sublime	Sadness --- Awe / Sublime
Either man?s work or his own gifts.	Awe / Sublime	Sadness --- Awe / Sublime
Who best	Awe / Sublime	Sadness --- Awe / Sublime
Bear his mild yoke, they serve him best.	Awe / Sublime	Sadness --- Awe / Sublime
His state	Awe / Sublime	Sadness --- Awe / Sublime

Is kingly: thousands at his bidding speed,	Beauty / Joy	Beauty / Joy --- Awe / Sublime
And post o?er land and ocean without rest;	Beauty / Joy	Beauty / Joy --- Awe / Sublime
They also serve who only stand and wait.?	Beauty / Joy	Beauty / Joy --- Awe / Sublime


On His Being Arrived to the Age of Twenty-Three?		

HOW soon hath Time, the subtle thief of youth,	Sadness	Sadness
Stolen on his wing my three and twentieth year!	Sadness	Sadness
My hasting days fly on with full career,	Vitality	Vitality
But my late spring no bud or blossom shew?th.	Vitality	Vitality
Perhaps my semblance might deceive the truth,	Vitality	Vitality
That I to manhood am arrived so near,	Vitality	Vitality
And inward ripeness doth much less appear,	Vitality	Vitality
That some more timely-happy spirits indu?th.	Vitality	Vitality
Yet be it less or more, or soon or slow,	Vitality	Vitality
It shall be still in strictest measure even	Vitality	Vitality
To that same lot, however mean or high,	Vitality --- Awe / Sublime	Vitality
Toward which Time leads me, and the will of Heaven,	Vitality --- Awe / Sublime	Vitality --- Awe / Sublime
All is, if I have grace to use it so,	Vitality --- Awe / Sublime	Vitality --- Awe / Sublime
As ever in my great Task-master?s eye	Vitality --- Awe / Sublime	Vitality --- Awe / Sublime


Mowing		

THERE was never a sound beside the wood but one ,	Beauty / Joy --- Suspense	Suspense --- Beauty / Joy
And that was my long scythe whispering to the ground .	Beauty / Joy --- Suspense	Suspense --- Beauty / Joy
What was it it whispered ?	Beauty / Joy --- Suspense	Beauty / Joy --- Suspense
I knew not well myself ;	Beauty / Joy --- Suspense	Beauty / Joy --- Suspense
Perhaps it was something about the heat of the sun ,	Beauty / Joy --- Suspense	Beauty / Joy
Something , perhaps , about the lack of sound ?	Beauty / Joy --- Suspense	Beauty / Joy
And that was why it whispered and did not speak .	Beauty / Joy	Beauty / Joy
It was no dream of the gift of idle hours ,	Beauty / Joy	Beauty / Joy
Or easy gold at the hand of fay or elf :	Beauty / Joy	Beauty / Joy
Anything more than the truth would have seemed too weak	Beauty / Joy	Beauty / Joy
To the earnest love that laid the swale in rows ,	Beauty / Joy	Beauty / Joy
Not without feeble-pointed spikes of flowers	Beauty / Joy	Beauty / Joy
( Pale orchises ) , and scared a bright green snake .	Beauty / Joy	Beauty / Joy
The fact is the sweetest dream that labor knows .	Beauty / Joy	Beauty / Joy
My long scythe whispered and left the hay to make .	Beauty / Joy	Beauty / Joy


Fire and Ice		

Some say the world will end in fire,	Awe / Sublime	Awe / Sublime
Some say in ice.	Awe / Sublime	Awe / Sublime
From what I?ve tasted of desire	Humor	Awe / Sublime --- Humor
I hold with those who favor fire.	Humor	Awe / Sublime --- Humor
But if it had to perish twice,	Humor	Awe / Sublime --- Humor
I think I know enough of hate	Humor	Awe / Sublime --- Humor
To say that for destruction ice	Humor	Awe / Sublime --- Humor
Is also great	Humor	Awe / Sublime --- Humor
And would suffice.	Humor	Awe / Sublime --- Humor


I Hear America Singing		

I hear America singing , the varied carols I hear ,	Beauty / Joy --- Vitality	Vitality --- Beauty / Joy
Those of mechanics , each one singing his as it should be blithe and strong ,	Beauty / Joy --- Vitality	Vitality --- Beauty / Joy
The carpenter singing his as he measures his plank or beam ,	Beauty / Joy --- Vitality	Vitality --- Beauty / Joy
The mason singing his as he makes ready for work , or leaves off work ,	Beauty / Joy --- Vitality	Vitality --- Beauty / Joy
The boatman singing what belongs to him in his boat , the deckhand	Beauty / Joy --- Vitality	Vitality --- Beauty / Joy
singing on the steamboat deck ,	Beauty / Joy --- Vitality	Vitality --- Beauty / Joy
The shoemaker singing as he sits on his bench , the hatter singing as	Beauty / Joy --- Vitality	Vitality --- Beauty / Joy
he stands ,	Beauty / Joy --- Vitality	Vitality --- Beauty / Joy
The wood-cutter "s song , the ploughboy "s on his way in the morning ,	Beauty / Joy --- Vitality	Vitality --- Beauty / Joy
or at noon intermission or at sundown ,	Beauty / Joy --- Vitality	Vitality --- Beauty / Joy
The delicious singing of the mother , or of the young wife at work ,	Beauty / Joy --- Vitality	Vitality --- Beauty / Joy
or of the girl sewing or washing ,	Beauty / Joy --- Vitality	Vitality --- Beauty / Joy
Each singing what belongs to him or her and to none else ,	Beauty / Joy --- Vitality	Vitality --- Beauty / Joy
The day what belongs to the day ? at night the party of young	Beauty / Joy --- Vitality	Vitality --- Beauty / Joy
fellows , robust , friendly ,	Beauty / Joy --- Vitality	Vitality --- Beauty / Joy
Singing with open mouths their strong melodious songs .	Beauty / Joy --- Vitality	Vitality --- Beauty / Joy


O Captain! My Captain!		

O Captain!	Beauty / Joy	Beauty / Joy
my Captain!	Beauty / Joy	Beauty / Joy
our fearful trip is done,	Beauty / Joy	Beauty / Joy
The ship has weather?d every rack, the prize we sought is won,	Beauty / Joy	Beauty / Joy
The port is near, the bells I hear, the people all exulting,	Beauty / Joy	Beauty / Joy
While follow eyes the steady keel, the vessel grim and daring;	Beauty / Joy	Beauty / Joy
But O heart!	Sadness	Sadness
heart!	Sadness	Sadness
heart!	Sadness	Sadness
O the bleeding drops of red,	Sadness	Sadness
Where on the deck my Captain lies,	Sadness	Sadness
Fallen cold and dead.	Sadness	Sadness

O Captain!	Vitality	Vitality
my Captain!	Vitality	Vitality
rise up and hear the bells;	Vitality	Vitality
Rise up?for you the flag is flung?for you the bugle trills,	Vitality	Vitality
For you bouquets and ribbon?d wreaths?for you the shores a-crowding,	Vitality	Vitality
For you they call, the swaying mass, their eager faces turning;	Vitality	Vitality
Here Captain!	Vitality	Vitality
dear father!	Vitality	Vitality
This arm beneath your head!	Vitality	Vitality
It is some dream that on the deck,	Sadness	Sadness
You?ve fallen cold and dead.	Sadness	Sadness

My Captain does not answer, his lips are pale and still,	Sadness	Sadness
My father does not feel my arm, he has no pulse nor will,	Sadness	Sadness
The ship is anchor?d safe and sound, its voyage closed and done,	Vitality	Sadness --- Vitality
From fearful trip the victor ship comes in with object won;	Vitality	Sadness --- Vitality
Exult O shores, and ring O bells!	Vitality	Sadness --- Vitality
But I with mournful tread,	Sadness	Sadness
Walk the deck my Captain lies,	Sadness	Sadness
Fallen cold and dead.	Sadness	Sadness


DANSE RUSSE		

If I when my wife is sleeping	Suspense	Suspense
and the baby and Kathleen	Suspense	Suspense
are sleeping	Suspense	Suspense
and the sun is a flame-white disc	Suspense	Suspense
in silken mists above shining trees ,?	Suspense	Suspense
if I in my north room	Suspense --- Humor	Suspense
danse naked , grotesquely	Suspense --- Humor	Suspense
before my mirror	Suspense --- Humor	Suspense
waving my shirt round my head	Suspense --- Humor	Suspense
and singing softly to myself :	Suspense --- Humor	Suspense
?I am lonely, lonely.	Humor	Humor
I was born to be lonely .	Humor	Humor
I am best so !?	Humor	Humor
If I admire my arms , my face,	Humor	Humor
my shoulders , flanks , buttocks	Humor	Humor
against the yellow drawn shades ,?	Humor	Humor

who shall say I am not	Humor	Humor
the happy genius of my household ?	Humor	Humor


To Waken an Old Lady		

OLD age is	Beauty / Joy	Suspense --- Beauty / Joy
a flight of small	Beauty / Joy	Suspense --- Beauty / Joy
cheeping birds	Beauty / Joy	Suspense --- Beauty / Joy
skimming	Beauty / Joy	Suspense --- Beauty / Joy
bare trees above a snow glaze.	Beauty / Joy	Suspense --- Beauty / Joy
Gaining and failing	Suspense --- Beauty / Joy	Beauty / Joy --- Suspense
they are buffeted	Suspense --- Beauty / Joy	Beauty / Joy --- Suspense
by a dark wind--	Suspense --- Beauty / Joy	Beauty / Joy --- Suspense
But what?	Suspense --- Beauty / Joy	Suspense --- Beauty / Joy
On harsh weedstalks	Beauty / Joy	Suspense --- Beauty / Joy
the flock has rested,	Beauty / Joy	Suspense --- Beauty / Joy
the snow	Beauty / Joy	Suspense --- Beauty / Joy
is covered with broken	Beauty / Joy	Suspense --- Beauty / Joy
seedhusks	Beauty / Joy	Suspense --- Beauty / Joy
and the wind tempered	Beauty / Joy	Suspense --- Beauty / Joy
by a shrill	Beauty / Joy	Suspense --- Beauty / Joy
piping of plenty.	Beauty / Joy	Suspense --- Beauty / Joy


My Love Is Like To Ice		

My love is like to ice, and I to fire:	Beauty / Joy	Beauty / Joy
How comes it then that this her cold so great	Sadness	Sadness
Is not dissolved through my so hot desire,	Sadness	Sadness
But harder grows the more I her entreat?	Sadness	Sadness
Or how comes it that my exceeding heat	Sadness	Sadness
Is not allayed by her heart-frozen cold,	Sadness	Sadness
But that I burn much more in boiling sweat,	Sadness	Sadness
And feel my flames augmented manifold?	Sadness	Sadness
What more miraculous thing may be told,	Beauty / Joy	Beauty / Joy
That fire, which all things melts, should harden ice,	Beauty / Joy	Beauty / Joy
And ice, which is congeal"s with senseless cold,	Beauty / Joy	Beauty / Joy
Should kindle fire by wonderful device?	Beauty / Joy	Beauty / Joy
Such is the power of love in gentle mind,	Awe / Sublime	Beauty / Joy --- Awe / Sublime
That it can alter all the course of kind.	Awe / Sublime	Beauty / Joy --- Awe / Sublime


Sonnet 54		

Of this worlds theatre in which we stay,	Beauty / Joy	Beauty / Joy
My love like the spectator ydly sits	Beauty / Joy	Beauty / Joy
Beholding me that all the pageants play,	Beauty / Joy	Beauty / Joy
Disguysing diversly my troubled wits.	Beauty / Joy	Beauty / Joy
Sometimes I joy when glad occasion fits,	Beauty / Joy	Beauty / Joy
And mask in myrth lyke to a comedy:	Beauty / Joy	Beauty / Joy
Soone after when my joy to sorrow flits,	Sadness	Sadness
I waile and make my woes a tragedy.	Sadness	Sadness
Yet she, beholding me with constant eye,	Sadness	Sadness
Delights not in my merth nor rues my smart:	Sadness	Sadness
But when I laugh she mocks, and when I cry	Sadness	Sadness
She laughs and hardens evermore her heart.	Sadness	Sadness
What then can move her?	Sadness	Sadness
if nor merth nor mone,	Sadness	Sadness
She is no woman, but a senceless stone.	Sadness	Sadness


ODE ON SOLITUDE		

Happy the man whose wish and care	Beauty / Joy	Beauty / Joy
A few paternal acres bound ,	Beauty / Joy	Beauty / Joy
Content to breathe his native air ,	Beauty / Joy	Beauty / Joy
In his own ground .	Beauty / Joy	Beauty / Joy

Whose herds with milk , whose fields with bread ,	Beauty / Joy	Beauty / Joy
Whose flocks supply him with attire ,	Beauty / Joy	Beauty / Joy
Whose trees in summer yield him shade ,	Beauty / Joy	Beauty / Joy
In winter fire .	Beauty / Joy	Beauty / Joy

Blest , who can unconcern"dly find	Beauty / Joy	Beauty / Joy
Hours , days , and years slide soft away ,	Beauty / Joy	Beauty / Joy
In health of body , peace of mind ,	Beauty / Joy	Beauty / Joy
Quiet by day ,	Beauty / Joy	Beauty / Joy

Sound sleep by night ; study and ease ,	Beauty / Joy	Beauty / Joy
Together mixt ; sweet recreation ;	Beauty / Joy	Beauty / Joy
And Innocence , which most does please	Beauty / Joy	Beauty / Joy
With meditation .	Beauty / Joy	Beauty / Joy

Thus let me live , unseen , unknown ,	Awe / Sublime	Vitality
Thus unlamented let me die ,	Awe / Sublime	Vitality
Steal from the world , and not a stone	Awe / Sublime	Vitality
Tell where I lie .	Awe / Sublime	Vitality


dying is fine)but Death		

?	Suspense	Suspense --- Humor
o	Suspense	Suspense --- Humor
baby	Suspense	Suspense --- Humor
i	Suspense	Suspense --- Humor

wouldn"t like	Suspense	Suspense --- Humor

Death if Death	Humor	Suspense --- Humor
were	Humor	Suspense --- Humor
good:for	Humor	Suspense --- Humor

when(instead of stopping to think)you	Humor	Suspense --- Humor

begin to feel of it,dying	Humor	Suspense --- Humor
"s miraculous	Humor	Suspense --- Humor
why?	Humor	Suspense --- Humor
be	Humor	Suspense --- Humor

cause dying is	Humor	Suspense --- Humor

perfectly natural;perfectly	Humor	Suspense --- Humor
putting	Humor	Suspense --- Humor
it mildly lively(but	Humor	Suspense --- Humor

Death	Humor	Suspense --- Humor

is strictly	Humor	Suspense --- Humor
scientific	Humor	Suspense --- Humor
&amp; artificial &amp;	Humor	Suspense --- Humor

evil &amp; legal)	Humor	Suspense --- Humor

we thank thee	Humor	Suspense --- Humor
god	Humor	Suspense --- Humor
almighty for dying	Humor	Suspense --- Humor
(forgive us,o life!	Humor	Suspense --- Humor
the sin of Death	Humor	Suspense --- Humor


[i carry your heart with me(i carry it in]		

i carry your heart with me(i carry it in	Beauty / Joy	Beauty / Joy
my heart)i am never without it(anywhere	Beauty / Joy	Beauty / Joy
i go you go,my dear;and whatever is done	Beauty / Joy	Beauty / Joy
by only me is your doing,my darling)	Beauty / Joy	Beauty / Joy
                                 i fear	Beauty / Joy	Beauty / Joy

no fate(for you are my fate,my sweet)i want	Beauty / Joy	Beauty / Joy
no world(for beautiful you are my world,my true)	Beauty / Joy	Beauty / Joy
and it?s you are whatever a moon has always meant	Beauty / Joy	Beauty / Joy
and whatever a sun will always sing is you	Beauty / Joy	Beauty / Joy

here is the deepest secret nobody knows	Beauty / Joy	Beauty / Joy
(here is the root of the root and the bud of the bud	Beauty / Joy	Beauty / Joy
and the sky of the sky of a tree called life;which grows	Beauty / Joy	Beauty / Joy
higher than soul can hope or mind can hide)	Beauty / Joy	Beauty / Joy
and this is the wonder that"s keeping the stars apart	Beauty / Joy	Beauty / Joy

i carry your heart(i carry it in my heart)	Beauty / Joy	Beauty / Joy


THE DESCENT OF DULLNESS		

In vain , in vain ? the all-composing Hour	Suspense	Suspense
Resistless falls : the Muse obeys the Pow"r .	Suspense	Suspense
She comes !	Suspense	Suspense
she comes !	Suspense	Suspense
the sable Throne behold	Suspense	Suspense
Of Night primval and of Chaos old !	Suspense	Suspense
Before her , Fancy "s gilded clouds decay ,	Sadness	Uneasiness
And all its varying Rain-bows die away .	Sadness	Uneasiness
Wit shoots in vain its momentary fires ,	Sadness	Uneasiness
The meteor drops , and in a flash expires .	Sadness	Uneasiness
As one by one , at dread Medea "s strain ,	Uneasiness	Uneasiness
The sick"ning stars fade off th ? ethereal plain ;	Uneasiness	Uneasiness
As Argus ? eyes by Hermes ? wand opprest ,	Uneasiness	Uneasiness
Clos "d one by one to everlasting rest ;	Uneasiness	Uneasiness
Thus at her felt approach , and secret might ,	Uneasiness	Uneasiness
Art after Art goes out , and all is Night .	Uneasiness	Uneasiness
See skulking Truth to her old cavern fled ,	Uneasiness	Sadness
Mountains of Casuistry heap "d o"er her head !	Uneasiness	Sadness
Philosophy , that lean "d on Heav"n before ,	Uneasiness	Sadness
Shrinks to her second cause , and is no more .	Uneasiness	Sadness
Physic of Metaphysic begs defence ,	Uneasiness	Sadness
And Metaphysic calls for aid on Sense !	Uneasiness	Sadness
See Mystery to Mathematics fly !	Uneasiness	Sadness
In vain !	Sadness --- Uneasiness	Sadness
they gaze , turn giddy , rave , and die .	Sadness --- Uneasiness	Sadness
Religion blushing veils her sacred fires ,	Sadness --- Uneasiness	Sadness
And unawares Morality expires .	Sadness --- Uneasiness	Sadness
For public Flame , nor private , dares to shine ;	Sadness --- Uneasiness	Sadness
Nor human Spark is left , nor Glimpse divine !	Sadness --- Uneasiness	Sadness
Lo !	Sadness --- Uneasiness	Uneasiness
thy dread Empire , CHAOS !	Sadness --- Uneasiness	Uneasiness
is restor "d ;	Sadness --- Uneasiness	Uneasiness
Light dies before thy uncreating word ;	Sadness --- Uneasiness	Uneasiness
Thy hand , great Anarch !	Sadness --- Uneasiness	Uneasiness
lets the curtain fall ,	Sadness --- Uneasiness	Uneasiness
And universal Darkness buries All .	Sadness --- Uneasiness	Uneasiness


I "m nobody ! Who are you ?		

I "m nobody !	Humor	Humor
Who are you ?	Humor	Humor
Are you nobody , too ?	Humor	Humor
Then there ? s a pair of us	Humor	Humor
? do n"t tell !	Humor	Humor
They ? d banish us , you know .	Humor	Humor

How dreary to be somebody !	Humor --- Sadness	Humor
How public , like a frog	Humor --- Sadness	Humor
To tell your name the livelong day	Humor --- Sadness	Humor
To an admiring bog !	Humor --- Sadness	Humor


The Flea		

Marke but this flea , and marke in this ,	Humor --- Beauty / Joy	Humor
How little that which thou deny"st me is ;	Humor --- Beauty / Joy	Humor
It suck "d me first , and now sucks thee ,	Humor --- Beauty / Joy	Humor
And in this flea , our two bloods mingled bee ;	Humor --- Beauty / Joy	Humor
Thou know"st that this cannot be said	Humor --- Beauty / Joy	Humor
A sinne , nor shame , nor losse of maidenhead ,	Humor --- Beauty / Joy	Humor
Yet this enjoyes before it wooe ,	Humor --- Beauty / Joy	Humor
And pamper "d swells with one blood made of two ,	Humor --- Beauty / Joy	Humor
And this , alas , is more then wee would doe .	Humor --- Beauty / Joy	Humor

Oh stay , three lives in one flea spare ,	Beauty / Joy	Humor
Where wee almost , yea more then maryed are .	Beauty / Joy	Humor
This flea is you and I , and this	Beauty / Joy	Humor
Our mariage bed , and mariage temple is ;	Beauty / Joy	Humor
Though parents grudge , and you , w"are met ,	Beauty / Joy	Uneasiness
And cloysterd in these living walls of Jet .	Beauty / Joy	Uneasiness
Though use make you apt to kill mee ,	Humor	Uneasiness
Let not to that , selfe murder added bee ,	Humor	Uneasiness
And sacrilege , three sinnes in killing three .	Humor	Uneasiness

Cruell and sodaine , hast thou since	Sadness	Uneasiness
Purpled thy naile , in blood of innocence ?	Sadness	Uneasiness
Wherein could this flea guilty bee ,	Sadness	Uneasiness
Except in that drop which it suckt from thee ?	Sadness	Uneasiness
Yet thou triumph"st , and saist that thou	Sadness	Uneasiness
Find"st not thy selfe , nor mee the weaker now ;	Sadness	Uneasiness
? Tis true , then learne how false , feares bee ; 25	Sadness	Uneasiness
Just so much honor , when thou yeeld"st to mee ,	Sadness	Uneasiness
Will wast , as this flea "s death tooke life from thee .	Sadness	Uneasiness


Song on May Morning		

NOW the bright morning-star, Day?s harbinger,	Beauty / Joy --- Vitality	Beauty / Joy
Comes dancing from the East, and leads with her	Beauty / Joy --- Vitality	Beauty / Joy
The flowery May, who from her green lap throws	Beauty / Joy --- Vitality	Beauty / Joy
The yellow cowslip and the pale primrose.	Beauty / Joy --- Vitality	Beauty / Joy
Hail, bounteous May, that dost inspire	Beauty / Joy --- Vitality	Beauty / Joy
Mirth, and youth, and warm desire!	Beauty / Joy --- Vitality	Beauty / Joy
Woods and groves are of thy dressing;	Beauty / Joy --- Vitality	Beauty / Joy
Hill and dale doth boast thy blessing.	Beauty / Joy --- Vitality	Beauty / Joy
Thus we salute thee with our early song,	Beauty / Joy --- Vitality	Beauty / Joy
And welcome thee, and wish thee long.	Beauty / Joy --- Vitality	Beauty / Joy


OZYMANDIAS		

I met a traveller from an antique land	Suspense	Suspense
Who said : Two vast and trunkless legs of stone	Suspense	Suspense
Stand in the desert ...	Uneasiness --- Suspense	Suspense
Near them , on the sand ,	Uneasiness --- Suspense	Suspense
Half sunk , a shattered visage lies , whose frown ,	Uneasiness --- Suspense	Suspense
And wrinkled lip , and sneer of cold command ,	Uneasiness --- Suspense	Suspense
Tell that its sculptor well those passions read	Uneasiness --- Suspense	Suspense
Which yet survive , stamped on these lifeless things ,	Uneasiness --- Suspense	Suspense
The hand that mocked them , and the heart that fed :	Uneasiness --- Suspense	Suspense
And on the pedestal these words appear :	Uneasiness --- Suspense	Suspense
? My name is Ozymandias , king of kings :	Uneasiness	Sadness
Look on my works , ye Mighty , and despair !	Uneasiness	Sadness
?	Uneasiness	Sadness
Nothing beside remains .	Sadness	Nostalgia --- Sadness
Round the decay	Sadness	Nostalgia --- Sadness
Of that colossal wreck , boundless and bare	Sadness	Nostalgia --- Sadness
The lone and level sands stretch far away .	Sadness	Nostalgia --- Sadness


Desert Places		

Snow falling and night falling fast, oh, fast	Beauty / Joy	Beauty / Joy
In a field I looked into going past,	Beauty / Joy	Beauty / Joy
And the ground almost covered smooth in snow,	Beauty / Joy	Beauty / Joy
But a few weeds and stubble showing last.	Beauty / Joy	Beauty / Joy

The woods around it have it--it is theirs.	Beauty / Joy	Sadness
All animals are smothered in their lairs.	Beauty / Joy	Sadness
I am too absent-spirited to count;	Sadness	Sadness
The loneliness includes me unawares.	Sadness	Sadness

And lonely as it is that loneliness	Sadness --- Uneasiness	Sadness
Will be more lonely ere it will be less--	Sadness --- Uneasiness	Sadness
A blanker whiteness of benighted snow	Sadness --- Uneasiness	Sadness
With no expression, nothing to express.	Sadness --- Uneasiness	Sadness

They cannot scare me with their empty spaces	Sadness --- Awe / Sublime	Sadness
Between stars--on stars where no human race is.	Sadness --- Awe / Sublime	Sadness
I have it in me so much nearer home	Sadness --- Awe / Sublime	Sadness
To scare myself with my own desert places.	Sadness --- Awe / Sublime	Sadness


If?		

If you can keep your head when all about you	Beauty / Joy --- Vitality	Vitality
Are losing theirs and blaming it on you,	Beauty / Joy --- Vitality	Vitality
If you can trust yourself when all men doubt you,	Beauty / Joy --- Vitality	Vitality
But make allowance for their doubting too;	Beauty / Joy --- Vitality	Vitality
If you can wait and not be tired by waiting,	Beauty / Joy --- Vitality	Vitality
Or being lied about, don?t deal in lies,	Beauty / Joy --- Vitality	Vitality
Or being hated, don?t give way to hating,	Beauty / Joy --- Vitality	Vitality
And yet don?t look too good, nor talk too wise:	Beauty / Joy --- Vitality	Vitality

If you can dream?and not make dreams your master;	Beauty / Joy --- Vitality	Vitality
If you can think?and not make thoughts your aim;	Beauty / Joy --- Vitality	Vitality
If you can meet with Triumph and Disaster	Beauty / Joy --- Vitality	Vitality
And treat those two impostors just the same;	Beauty / Joy --- Vitality	Vitality
If you can bear to hear the truth you?ve spoken	Beauty / Joy --- Vitality	Vitality
Twisted by knaves to make a trap for fools,	Beauty / Joy --- Vitality	Vitality
Or watch the things you gave your life to, broken,	Beauty / Joy --- Vitality	Vitality
And stoop and build ?em up with worn-out tools:	Beauty / Joy --- Vitality	Vitality

If you can make one heap of all your winnings	Beauty / Joy --- Vitality	Vitality
And risk it on one turn of pitch-and-toss,	Beauty / Joy --- Vitality	Vitality
And lose, and start again at your beginnings	Beauty / Joy --- Vitality	Vitality
And never breathe a word about your loss;	Beauty / Joy --- Vitality	Vitality
If you can force your heart and nerve and sinew	Beauty / Joy --- Vitality	Vitality
To serve your turn long after they are gone,	Beauty / Joy --- Vitality	Vitality
And so hold on when there is nothing in you	Beauty / Joy --- Vitality	Vitality
Except the Will which says to them: ?Hold on!?	Beauty / Joy --- Vitality	Vitality

If you can talk with crowds and keep your virtue,	Awe / Sublime	Vitality --- Awe / Sublime
Or walk with Kings?nor lose the common touch,	Awe / Sublime	Vitality --- Awe / Sublime
If neither foes nor loving friends can hurt you,	Awe / Sublime	Vitality --- Awe / Sublime
If all men count with you, but none too much;	Awe / Sublime	Vitality --- Awe / Sublime
If you can fill the unforgiving minute	Awe / Sublime	Vitality --- Awe / Sublime
With sixty seconds? worth of distance run,	Awe / Sublime	Vitality --- Awe / Sublime
Yours is the Earth and everything that?s in it,	Awe / Sublime	Vitality --- Awe / Sublime
And?which is more?you?ll be a Man, my son!	Awe / Sublime	Vitality --- Awe / Sublime


A Noiseless Patient Spider		

A noiseless patient spider ,	Vitality	Sadness
I mark "d where on a little promontory it stood isolated ,	Vitality	Sadness
Mark "d how to explore the vacant vast surrounding ,	Vitality	Sadness
It launch "d forth filament , filament , filament out of itself ,	Vitality	Sadness
Ever unreeling them , ever tirelessly speeding them .	Vitality	Sadness

And you O my soul where you stand ,	Sadness --- Awe / Sublime	Sadness
Surrounded , detached , in measureless oceans of space ,	Sadness --- Awe / Sublime	Sadness
Ceaselessly musing , venturing , throwing , seeking the spheres to	Sadness --- Awe / Sublime	Sadness
connect them ,	Sadness --- Awe / Sublime	Sadness
Till the bridge you will need be form "d , till the ductile anchor hold ,	Sadness --- Awe / Sublime	Sadness
Till the gossamer thread you fling catch somewhere , O my soul .	Sadness --- Awe / Sublime	Sadness


LONDON		

I wandered through each chartered street ,	Nostalgia	Sadness --- Nostalgia
Near where the chartered Thames does flow ,	Nostalgia	Sadness --- Nostalgia
A mark in every face I meet ,	Nostalgia	Sadness --- Nostalgia
Marks of weakness , marks of woe .	Nostalgia	Sadness --- Nostalgia

In every cry of every man ,	Sadness	Sadness --- Annoyance
In every infant "s cry of fear ,	Sadness	Sadness --- Annoyance
In every voice , in every ban ,	Sadness	Sadness --- Annoyance
The mind-forged manacles I hear :	Sadness	Sadness --- Annoyance

How the chimney-sweeper "s cry	Sadness	Sadness --- Annoyance
Every blackening church appalls ,	Sadness	Sadness --- Annoyance
And the hapless soldier "s sigh	Annoyance --- Sadness	Sadness --- Annoyance
Runs in blood down palace-walls .	Annoyance --- Sadness	Sadness --- Annoyance

But most , through midnight streets I hear	Annoyance --- Sadness	Sadness --- Annoyance
How the youthful harlot "s curse	Annoyance --- Sadness	Sadness --- Annoyance
Blasts the new-born infant "s tear ,	Annoyance --- Sadness	Sadness --- Annoyance
And blights with plagues the marriage-hearse .	Annoyance --- Sadness	Sadness --- Annoyance


The Young Housewife		

AT ten A.M. the young housewife	Beauty / Joy --- Suspense	Beauty / Joy
moves about in negligee behind	Beauty / Joy --- Suspense	Beauty / Joy
the wooden walls of her husband"s house.	Beauty / Joy --- Suspense	Beauty / Joy
I pass solitary in my car.	Beauty / Joy	Beauty / Joy
Then again she comes to the curb	Beauty / Joy	Sadness
to call the ice-man, fish-man, and stands	Beauty / Joy	Sadness
shy, uncorseted, tucking in	Beauty / Joy	Sadness
stray ends of hair, and I compare her	Beauty / Joy --- Sadness	Sadness
to a fallen leaf.	Beauty / Joy --- Sadness	Sadness
The noiseless wheels of my car	Beauty / Joy --- Sadness	Sadness
rush with a crackling sound over	Beauty / Joy --- Sadness	Sadness
dried leaves as I bow and pass smiling.	Beauty / Joy --- Sadness	Sadness


I wandered lonely as a Cloud		

I wandered lonely as a Cloud	Nostalgia --- Beauty / Joy	Nostalgia --- Beauty / Joy
That floats on high over Vales and Hills ,	Nostalgia --- Beauty / Joy	Nostalgia --- Beauty / Joy
When all at once I saw a crowd	Nostalgia --- Beauty / Joy	Nostalgia --- Beauty / Joy
A host of dancing Daffodills ;	Nostalgia --- Beauty / Joy	Nostalgia --- Beauty / Joy
Along the Lake , beneath the trees ,	Nostalgia --- Beauty / Joy	Nostalgia --- Beauty / Joy
Ten thousand dancing in the breeze .	Nostalgia --- Beauty / Joy	Nostalgia --- Beauty / Joy

Continuous as the stars that shine	Nostalgia --- Beauty / Joy	Beauty / Joy
And twinkle on the milky way,	Nostalgia --- Beauty / Joy	Beauty / Joy
They stretched in never-ending line	Nostalgia --- Beauty / Joy	Beauty / Joy
Along the margin of a bay:	Nostalgia --- Beauty / Joy	Beauty / Joy
Ten thousand saw I at a glance,	Nostalgia --- Beauty / Joy	Beauty / Joy
Tossing their heads in sprightly dance.	Nostalgia --- Beauty / Joy	Beauty / Joy

The waves beside them danced , but they	Beauty / Joy --- Vitality	Beauty / Joy
Outdid the sparkling waves in glee :?	Beauty / Joy --- Vitality	Beauty / Joy
A Poet could not but be gay	Beauty / Joy --- Vitality	Beauty / Joy
In such a laughing company :	Beauty / Joy --- Vitality	Beauty / Joy
I gazed ? and gazed ? but little thought	Beauty / Joy --- Suspense	Beauty / Joy --- Suspense
What wealth the shew to me had brought :	Beauty / Joy --- Suspense	Beauty / Joy --- Suspense

For oft when on my couch I lie	Nostalgia --- Beauty / Joy	Nostalgia --- Beauty / Joy
In vacant or in pensive mood ,	Nostalgia --- Beauty / Joy	Nostalgia --- Beauty / Joy
They flash upon that inward eye	Nostalgia --- Beauty / Joy	Nostalgia --- Beauty / Joy
Which is the bliss of solitude ,	Nostalgia --- Beauty / Joy	Nostalgia --- Beauty / Joy
And then my heart with pleasure fills ,	Nostalgia --- Beauty / Joy	Nostalgia --- Beauty / Joy
And dances with the Daffodils .	Nostalgia --- Beauty / Joy	Nostalgia --- Beauty / Joy




