Weltende		

Es ist ein Weinen in der Welt,	Sadness	Sadness
Als ob der liebe Gott gestorben wär,	Sadness	Sadness
Und der bleierne Schatten, der niederfällt,	Sadness	Sadness
Lastet grabesschwer.	Sadness	Sadness

Komm, wir wollen uns näher verbergen?	Sadness	Sadness
Das Leben liegt in aller Herzen	Sadness	Sadness --- Uneasiness
Wie in Särgen.	Sadness	Sadness --- Uneasiness

Du! wir wollen uns tief küssen -	Sadness --- Vitality	Sadness
Es pocht eine Sehnsucht an die Welt,	Sadness --- Vitality	Sadness --- Uneasiness
An der wir sterben müssen.	Sadness	Sadness --- Uneasiness


Die Irren		

Der Mond tritt aus der gelben Wolkenwand.	Uneasiness	Uneasiness
Die Irren hängen an den Gitterstäben,	Uneasiness	Uneasiness
Wie große Spinnen, die an Mauern kleben.	Uneasiness	Uneasiness
Entlang den Gartenzaun fährt ihre Hand.	Uneasiness	Uneasiness

In offnen Sälen sieht man Tänzer schweben.	Uneasiness --- Beauty / Joy	Suspense
Der Ball der Irren ist es. Plötzlich schreit	Uneasiness	Suspense --- Uneasiness
Der Wahnsinn auf. Das Brüllen pflanzt sich weit,	Uneasiness	Suspense --- Uneasiness
Daß alle Mauern von dem Lärme beben.	Uneasiness	Suspense --- Uneasiness

Mit dem er eben über Hume gesprochen,	Sadness --- Uneasiness	Humor
Den Arzt ergreift ein Irrer mit Gewalt.	Sadness --- Uneasiness	Humor
Er liegt im Blut. Sein Schädel ist zebrochen.	Sadness --- Uneasiness	Uneasiness

Der Haufe Irrer schaut vergnügt. Doch bald	Sadness --- Uneasiness	Uneasiness
Enthuschen sie, da fern die Peitsche knallt,	Sadness --- Uneasiness	Uneasiness
Den Mäusen gleich, die in die Erde krochen.	Sadness --- Uneasiness	Uneasiness


An die Verstummten		

O, der Wahnsinn der großen Stadt, da am Abend	Uneasiness	Uneasiness
An schwarzer Mauer verkrüppelte Bäume starren,	Uneasiness	Uneasiness
Aus silberner Maske der Geist des Bösen schaut;	Uneasiness	Uneasiness
Licht mit magnetischer Geißel die steinerne Nacht verdrängt.	Uneasiness --- Beauty / Joy	Beauty / Joy
O, das versunkene Läuten der Abendglocken.	Uneasiness --- Beauty / Joy	Beauty / Joy

Hure, die in eisigen Schauern ein totes Kindlein gebärt.	Uneasiness	Uneasiness
Rasend peitscht Gottes Zorn die Stirne der Besessenen,	Uneasiness	Uneasiness
Purpurne Seuche, Hunger, der grüne Augen zerbricht.	Uneasiness	Uneasiness
O, das gräßliche Lachen des Golds.	Uneasiness --- Sadness	Uneasiness

Aber stille blutet in dunkler Höhle stummere Menschheit,	Uneasiness	Uneasiness
Fügt aus harten Metallen das erlösende Haupt.	Uneasiness	Uneasiness


Der Spruch		

In einem alten Buche stieß ich auf ein Wort,	Awe / Sublime --- Suspense	Suspense
Das traf mich wie ein Schlag und brennt durch meine Tage fort:	Awe / Sublime --- Suspense	Suspense
Und wenn ich mich an trübe Lust vergebe,	Awe / Sublime	Awe / Sublime --- Suspense
Schein, Lug und Spiel zu mir anstatt des Wesens hebe,	Awe / Sublime	Awe / Sublime --- Suspense
Wenn ich gefällig mich mit raschem Sinn belüge,	Awe / Sublime	Awe / Sublime --- Suspense
Als wäre Dunkles klar, als wenn nicht Leben tausend wild verschloßne Tore trüge,	Awe / Sublime	Awe / Sublime --- Suspense
Und Worte wiederspreche, deren Weite nie ich ausgefühlt,	Awe / Sublime	Awe / Sublime --- Suspense
Und Dinge fasse, deren Sein mich niemals aufgewühlt,	Awe / Sublime	Awe / Sublime --- Suspense
Wenn mich willkommner Traum mit Sammethänden streicht,	Awe / Sublime	Awe / Sublime --- Suspense
Und Tag und Wirklichkeit von mir entweicht,	Awe / Sublime	Awe / Sublime --- Suspense
Der Welt entfremdet, fremd dem tiefsten Ich,	Awe / Sublime	Awe / Sublime --- Suspense
Dann steht das Wort mir auf: Mensch, werde wesentlich!	Awe / Sublime	Awe / Sublime --- Suspense


Nachthimmel und Sternenfall		

Der Himmel, groß, voll herrlicher Verhaltung,	Awe / Sublime	Awe / Sublime
ein Vorrat Raum, ein Übermaß von Welt.	Awe / Sublime	Awe / Sublime
Und wir, zu ferne für die Angestaltung,	Awe / Sublime --- Sadness	Awe / Sublime --- Sadness
zu nahe für die Abkehr hingestellt.	Awe / Sublime --- Sadness	Awe / Sublime --- Sadness

Da fällt ein Stern! Und unser Wunsch an ihn,	Beauty / Joy	Beauty / Joy --- Suspense
bestürzten Aufblicks, dringend angeschlossen:	Sadness --- Beauty / Joy	Beauty / Joy --- Suspense
Was ist begonnen, und was ist verflossen?	Sadness --- Beauty / Joy	Awe / Sublime --- Beauty / Joy
Was ist verschuldet? Und was ist verziehn?	Sadness --- Beauty / Joy	Awe / Sublime --- Beauty / Joy


Auf dem See / aufm Zürichersee		

Und frische Nahrung, neues Blut	Vitality	Beauty / Joy --- Vitality
Saug? ich aus freyer Welt;	Vitality	Beauty / Joy --- Vitality
Wie ist Natur so hold und gut,	Vitality	Beauty / Joy --- Vitality
Die mich am Busen hält!	Vitality	Beauty / Joy --- Vitality
Die Welle wieget unsern Kahn	Beauty / Joy	Beauty / Joy --- Vitality
Im Rudertakt hinauf,	Beauty / Joy	Beauty / Joy --- Vitality
Und Berge, wolkig himmelan,	Beauty / Joy	Beauty / Joy --- Vitality
Begegnen unserm Lauf.	Beauty / Joy	Beauty / Joy --- Vitality

Aug?, mein Aug?, was sinkst du nieder?	Vitality --- Sadness	Sadness
Goldne Träume kommt ihr wieder?	Vitality --- Sadness	Sadness
Weg, du Traum! so Gold du bist;	Vitality	Vitality
Hier auch Lieb? und Leben ist.	Vitality	Vitality

Auf der Welle blinken	Beauty / Joy	Beauty / Joy
Tausend schwebende Sterne,	Beauty / Joy	Beauty / Joy
Weiche Nebel trinken	Beauty / Joy	Beauty / Joy
Rings die thürmende Ferne;	Beauty / Joy	Beauty / Joy
Morgenwind umflügelt	Beauty / Joy	Beauty / Joy
Die beschattete Bucht,	Beauty / Joy	Beauty / Joy
Und im See bespiegelt	Beauty / Joy	Beauty / Joy
Sich die reifende Frucht.	Beauty / Joy	Beauty / Joy


Heidenröslein / Heideröslein		

Sah ein Knab? ein Röslein stehn,	Suspense --- Beauty / Joy	Beauty / Joy
Röslein auf der Heiden,	Suspense --- Beauty / Joy	Beauty / Joy
War so jung und morgenschön,	Suspense --- Beauty / Joy	Beauty / Joy
Lief er schnell es nah zu sehn,	Suspense --- Beauty / Joy	Beauty / Joy
Sah?s mit vielen Freuden.	Suspense --- Beauty / Joy	Beauty / Joy
Röslein, Röslein, Röslein roth,	Suspense --- Beauty / Joy	Beauty / Joy
Röslein auf der Heiden.	Suspense --- Beauty / Joy	Beauty / Joy

Knabe sprach: ich breche dich,	Beauty / Joy --- Suspense	Suspense
Röslein auf der Heiden!	Beauty / Joy --- Suspense	Suspense
Röslein sprach: ich steche dich,	Beauty / Joy	Beauty / Joy
Daß du ewig denkst an mich,	Beauty / Joy	Beauty / Joy
Und ich will?s nicht leiden.	Beauty / Joy	Beauty / Joy
Röslein, Röslein, Röslein roth,	Beauty / Joy	Beauty / Joy
Röslein auf der Heiden.	Beauty / Joy	Beauty / Joy

Und der wilde Knabe brach	Beauty / Joy --- Humor	Sadness
?s Röslein auf der Heiden;	Beauty / Joy --- Humor	Sadness
Röslein wehrte sich und stach,	Beauty / Joy --- Humor	Sadness
Half ihm doch kein Weh und Ach,	Beauty / Joy --- Humor	Sadness
Mußt? es eben leiden.	Beauty / Joy --- Humor	Sadness
Röslein, Röslein, Röslein roth,	Beauty / Joy	Sadness
Röslein auf der Heiden.	Beauty / Joy	Sadness


Der Spinnerin Nachtlied / Es sang vor langen Jahren		

Es sang vor langen Jahren	Beauty / Joy	Beauty / Joy
Wohl auch die Nachtigall,	Beauty / Joy	Beauty / Joy
Das war wohl süßer Schall,	Beauty / Joy	Beauty / Joy --- Sadness
Da wir zusammen waren.	Beauty / Joy	Beauty / Joy --- Sadness

Ich sing' und kann nicht weinen,	Beauty / Joy --- Sadness	Sadness
Und spinne so allein	Beauty / Joy --- Sadness	Sadness
Den Faden klar und rein	Beauty / Joy --- Sadness	Sadness
So lang der Mond wird scheinen.	Beauty / Joy --- Sadness	Sadness

Als wir zusammen waren	Sadness	Sadness
Da sang die Nachtigall	Sadness	Sadness
Nun mahnet mich ihr Schall	Sadness	Sadness
Daß du von mir gefahren.	Sadness	Sadness

So oft der Mond mag scheinen,	Sadness --- Beauty / Joy	Sadness
Denk' ich wohl dein allein.	Sadness --- Beauty / Joy	Sadness
Mein Herz ist klar und rein,	Sadness --- Beauty / Joy	Sadness
Gott wolle uns vereinen.	Sadness --- Beauty / Joy	Sadness

Seit du von mir gefahren,	Sadness	Sadness
Singt stets die Nachtigall,	Sadness	Sadness
Ich denk' bei ihrem Schall,	Sadness	Sadness
Wie wir zusammen waren.	Sadness	Sadness

Gott wolle uns vereinen	Sadness	Sadness
Hier spinn'ich so allein,	Sadness	Sadness
Der Mond scheint klar und rein,	Sadness	Sadness
Ich sing' und möchte weinen.	Sadness	Sadness


Das zerbrochene Ringlein		

In einem kühlen Grunde	Beauty / Joy	Sadness
Da geht ein Mühlenrad,	Beauty / Joy	Sadness
Mein Liebste ist verschwunden,	Sadness	Sadness
Die dort gewohnet hat.	Sadness	Sadness

Sie hat mir Treu versprochen,	Sadness	Sadness
Gab mir ein'n Ring dabei,	Sadness	Sadness
Sie hat die Treu gebrochen,	Sadness	Sadness
Mein Ringlein sprang entzwei.	Sadness	Sadness

Ich möcht als Spielmann reisen	Vitality	Vitality
Weit in die Welt hinaus,	Vitality	Vitality
Und singen meine Weisen,	Vitality	Vitality
Und gehn von Haus zu Haus.	Vitality	Vitality

Ich möcht als Reiter fliegen	Vitality	Vitality
Wohl in die blut'ge Schlacht,	Vitality	Vitality
Um stille Feuer liegen	Vitality	Vitality
Im Feld bei dunkler Nacht.	Vitality	Vitality

Hör ich das Mühlrad gehen:	Sadness	Sadness
Ich weiß nicht, was ich will -	Sadness	Sadness
Ich möcht am liebsten sterben,	Sadness	Sadness
Da wär's auf einmal still!	Sadness	Sadness


Ännchen von Tharau		

Ännchen von Tharau ist's die mir gefällt,	Beauty / Joy	Beauty / Joy
Sie ist mein Leben, mein Gut und mein Geld.	Beauty / Joy	Beauty / Joy
Ännchen von Tharau hat wieder ihr Herz	Beauty / Joy	Beauty / Joy
Auf mich gerichtet, in Lieb und in Schmerz	Beauty / Joy	Beauty / Joy
Ännchen von Tharau, mein Reichtum, mein Gut,	Beauty / Joy --- Awe / Sublime	Beauty / Joy
Du meine Seele, mein Fleisch und mein Blut.	Beauty / Joy --- Awe / Sublime	Beauty / Joy

Käm' alles Wetter gleich auf uns zu schlah'n	Beauty / Joy --- Awe / Sublime	Vitality --- Beauty / Joy
Wir sind gesinnt, beieinander zu stah'n.	Beauty / Joy --- Awe / Sublime	Vitality --- Beauty / Joy
Krankheit, Verfolgung, Betrübnis und Pein	Beauty / Joy --- Awe / Sublime	Vitality --- Beauty / Joy
Soll unsrer Liebe Verknotigung sein.	Beauty / Joy --- Awe / Sublime	Vitality --- Beauty / Joy
Ännchen von Tharau, mein Reichtum, mein Gut,	Beauty / Joy --- Awe / Sublime	Beauty / Joy
Du meine Seele, mein Fleisch und mein Blut.	Beauty / Joy --- Awe / Sublime	Beauty / Joy

Recht als ein Palmbaum über sich steigt,	Beauty / Joy	Beauty / Joy
Je mehr ihn Hagel und Regen angreift:	Beauty / Joy	Beauty / Joy
So werd' die Lieb in uns mächtig und groß,	Beauty / Joy --- Awe / Sublime	Beauty / Joy --- Vitality
Durch Kreuz, durch Leiden, durch allerlei Not.	Beauty / Joy --- Awe / Sublime	Beauty / Joy --- Vitality
Ännchen von Tharau, mein Reichtum, mein Gut,	Beauty / Joy --- Awe / Sublime	Beauty / Joy
Du meine Seele, mein Fleisch und mein Blut.	Beauty / Joy --- Awe / Sublime	Beauty / Joy

Würdest du gleich einmal von mir getrennt,	Beauty / Joy --- Vitality	Beauty / Joy
Lebtest da, wo man die Sonne kaum kennt:	Beauty / Joy --- Vitality	Beauty / Joy
Ich will dir folgen, durch Wälder, durch Meer,	Beauty / Joy --- Vitality	Beauty / Joy --- Vitality
Durch Eis, durch Eisen, durch feindliches Heer.	Beauty / Joy --- Vitality	Beauty / Joy --- Vitality
Ännchen von Tharau, mein' Sonne, mein Schein,	Beauty / Joy --- Awe / Sublime	Beauty / Joy
Mein Leben schließ' ich in deines hinein	Beauty / Joy --- Awe / Sublime	Beauty / Joy


Die Lore-Ley / Ich weiß nicht was soll es bedeuten		

Ich weiß nicht was soll es bedeuten,	Sadness	Sadness
Dass ich so traurig bin;	Sadness	Sadness
Ein Märchen aus uralten Zeiten,	Sadness	Suspense
Das kommt mir nicht aus dem Sinn.	Sadness	Suspense

Die Luft ist kühl und es dunkelt,	Beauty / Joy	Beauty / Joy
Und ruhig fließt der Rhein;	Beauty / Joy	Beauty / Joy
Der Gipfel des Berges funkelt	Beauty / Joy	Beauty / Joy
Im Abendsonnenschein.	Beauty / Joy	Beauty / Joy

Die schönste Jungfrau sitzet	Beauty / Joy	Beauty / Joy
Dort oben wunderbar;	Beauty / Joy	Beauty / Joy
Ihr goldnes Geschmeide blitzet,	Beauty / Joy	Beauty / Joy
Sie kämmt ihr goldenes Haar.	Beauty / Joy	Beauty / Joy

Sie kämmt es mit goldenem Kamme	Beauty / Joy	Beauty / Joy
Und singt ein Lied dabei;	Beauty / Joy	Beauty / Joy
Das hat eine wundersame,	Beauty / Joy	Beauty / Joy
Gewaltige Melodei.	Beauty / Joy	Beauty / Joy

Den Schiffer im kleinen Schiffe	Suspense --- Beauty / Joy	Beauty / Joy
Ergreift es mit wildem Weh;	Suspense --- Beauty / Joy	Beauty / Joy
Er schaut nicht die Felsenriffe,	Suspense --- Beauty / Joy	Beauty / Joy
Er schaut nur hinauf in die Höh.	Suspense --- Beauty / Joy	Beauty / Joy

Ich glaube, die Wellen verschlingen	Sadness	Beauty / Joy
Am Ende Schiffer und Kahn;	Sadness	Beauty / Joy
Und das hat mit ihrem Singen	Sadness	Beauty / Joy
Die Lore-Ley getan.	Sadness	Beauty / Joy


Wünschelrute		

Schläft ein Lied in allen Dingen,	Awe / Sublime --- Beauty / Joy	Beauty / Joy --- Awe / Sublime
Die da träumen fort und fort,	Awe / Sublime --- Beauty / Joy	Beauty / Joy --- Awe / Sublime
Und die Welt hebt an zu singen,	Awe / Sublime --- Beauty / Joy	Beauty / Joy --- Awe / Sublime
Triffst du nur das Zauberwort.	Awe / Sublime --- Beauty / Joy	Beauty / Joy --- Awe / Sublime


Abendlied		

Augen, meine lieben Fensterlein,	Beauty / Joy	Beauty / Joy
Gebt mir schon so lange holden Schein,	Beauty / Joy	Beauty / Joy
Lasset freundlich Bild um Bild herein:	Beauty / Joy	Beauty / Joy
Einmal werdet ihr verdunkelt sein!	Beauty / Joy --- Sadness	Uneasiness

Fallen einst die müden Lider zu,	Sadness --- Beauty / Joy	Beauty / Joy
Löscht ihr aus, dann hat die Seele Ruh;	Sadness --- Beauty / Joy	Beauty / Joy
Tastend streift sie ab die Wanderschuh',	Sadness --- Beauty / Joy	Beauty / Joy
Legt sich auch in ihre finstre Truh.	Sadness --- Beauty / Joy	Beauty / Joy

Noch zwei Fünklein sieht sie glimmend stehn,	Sadness --- Beauty / Joy	Beauty / Joy
Wie zwei Sternlein innerlich zu sehn,	Sadness --- Beauty / Joy	Beauty / Joy
Bis sie schwanken und dann auch vergehn,	Sadness --- Beauty / Joy	Beauty / Joy
Wie von eines Falters Flügelwehn.	Sadness --- Beauty / Joy	Beauty / Joy

Doch noch wandl' ich auf dem Abendfeld,	Vitality	Beauty / Joy
Nur dem sinkenden Gestirn gesellt;	Vitality	Beauty / Joy
Trinkt, o Augen, was die Wimper hält,	Vitality	Beauty / Joy --- Awe / Sublime
Von dem goldnen Überfluß der Welt!	Vitality	Beauty / Joy --- Awe / Sublime


Weltende		

Dem Bürger fliegt vom spitzen Kopf der Hut,	Uneasiness	Humor
In allen Lüften hallt es wie Geschrei.	Uneasiness	Uneasiness
Dachdecker stürzen ab und gehn entzwei	Uneasiness	Uneasiness
Und an den Küsten ? liest man ? steigt die Flut.	Uneasiness	Uneasiness --- Humor

Der Sturm ist da, die wilden Meere hupfen	Uneasiness	Beauty / Joy
An Land, um dicke Dämme zu zerdrücken.	Uneasiness	Beauty / Joy
Die meisten Menschen haben einen Schnupfen.	Uneasiness --- Humor	Humor
Die Eisenbahnen fallen von den Brücken.	Uneasiness	Uneasiness


Beschreibung vollkommener Schönheit / Ein haar so kühnlich		

Ein haar so kühnlich trotz der Berenice spricht	Beauty / Joy	Beauty / Joy
Ein mund / der rosen führt und perlen in sich heget	Beauty / Joy	Beauty / Joy
Ein zünglein / so ein gifft vor tausend hertzen träget	Beauty / Joy	Beauty / Joy
Zwo brüste / wo rubin durch alabaster bricht	Beauty / Joy	Beauty / Joy

Ein hals / der schwanen-schnee weit weit zurücke sticht	Beauty / Joy	Beauty / Joy
Zwey wangen / wo die pracht der Flora sich beweget	Beauty / Joy	Beauty / Joy
Ein blick / der blitze führt und männer niederleget	Beauty / Joy	Beauty / Joy
Zwey armen / derer krafft offt leuen hingericht	Beauty / Joy	Beauty / Joy

Ein hertz / aus welchem nichts als mein verderben quillet	Beauty / Joy --- Sadness	Sadness
Ein wort / so himmlisch ist / und mich verdammen kan	Beauty / Joy --- Sadness	Sadness
Zwey hände / derer grimm mich in den bann gethan	Beauty / Joy --- Sadness	Sadness

Und durch ein süsses gifft die seele selbst umhüllet	Beauty / Joy --- Sadness	Beauty / Joy
Ein zierrath / wie es scheint / im paradieß gemacht	Beauty / Joy --- Sadness	Beauty / Joy
Hat mich um meinen witz und meine freyheit bracht.	Beauty / Joy --- Sadness	Beauty / Joy


Deutschland. Ein Wintermärchen, Caput 18 / XVIII		

Minden ist eine feste Burg,	Humor	Vitality
Hat gute Wehr und Waffen!	Humor	Vitality
Mit preußischen Festungen hab ich jedoch	Humor	Vitality
Nicht gerne was zu schaffen.	Humor	Vitality

Wir kamen dort an zur Abendzeit.	Suspense	Uneasiness
Die Planken der Zugbrück' stöhnten	Suspense --- Uneasiness	Uneasiness
So schaurig, als wir hinübergerollt;	Suspense --- Uneasiness	Uneasiness
Die dunklen Gräben gähnten.	Suspense --- Uneasiness	Uneasiness

Die hohen Bastionen schauten mich an,	Uneasiness	Uneasiness
So drohend und verdrossen;	Uneasiness	Uneasiness
Das große Tor ging rasselnd auf,	Uneasiness	Uneasiness
Ward rasselnd wieder geschlossen.	Uneasiness	Uneasiness

Ach! meine Seele ward betrübt,	Sadness	Sadness
Wie des Odysseus Seele,	Sadness	Sadness
Als er gehört, daß Polyphem	Sadness	Sadness
Den Felsblock schob vor die Höhle.	Sadness	Sadness

Es trat an den Wagen ein Korporal	Suspense	Suspense
Und frug uns: wie wir hießen?	Suspense	Suspense
»Ich heiße Niemand, bin Augenarzt	Suspense	Suspense
Und steche den Star den Riesen.«	Suspense	Suspense

Im Wirtshaus ward mir noch schlimmer zumut,	Sadness	Sadness
Das Essen wollt mir nicht schmecken.	Sadness	Sadness
Ging schlafen sogleich, doch schlief ich nicht,	Sadness	Sadness
Mich drückten so' schwer die Decken.	Sadness	Sadness

Es war ein breites Federbett,	Beauty / Joy	Beauty / Joy
Gardinen von rotem Damaste,	Beauty / Joy	Beauty / Joy
Der Himmel von verblichenem Gold,	Beauty / Joy	Beauty / Joy
Mit einem schmutzigen Quaste.	Beauty / Joy	Beauty / Joy

Verfluchter Quast! der die ganze Nacht	Humor	Uneasiness
Die liebe Ruhe mir raubte!	Humor	Uneasiness
Er hing mir, wie des Damokles Schwert,	Uneasiness	Uneasiness
So drohend über dem Haupte!	Uneasiness	Uneasiness

Schien manchmal ein Schlangenkopf zu sein,	Uneasiness	Uneasiness
Und ich hörte ihn heimlich zischen:	Uneasiness	Uneasiness
»Du bist und bleibst in der Festung jetzt,	Uneasiness	Uneasiness
Du kannst nicht mehr entwischen!«	Uneasiness	Uneasiness

»Oh, daß ich wäre« ? seufzte ich ?,	Sadness	Sadness
»Daß ich zu Hause wäre,	Sadness	Sadness
Bei meiner lieben Frau in Paris,	Sadness	Sadness
Im Faubourg Poissonnière!«	Sadness	Sadness

Ich fühlte, wie über die Stirne mir	Uneasiness	Uneasiness
Auch manchmal etwas gestrichen,	Uneasiness	Uneasiness
Gleich einer kalten Zensorhand,	Uneasiness	Uneasiness
Und meine Gedanken wichen ?	Uneasiness	Uneasiness

Gendarmen in Leichenlaken gehüllt,	Uneasiness	Uneasiness
Ein weißes Spukgewirre,	Uneasiness	Uneasiness
Umringte mein Bett, ich hörte auch	Uneasiness	Uneasiness
Unheimliches Kettengeklirre.	Uneasiness	Uneasiness

Ach! Die Gespenster schleppten mich fort,	Uneasiness	Uneasiness
Und ich hab mich endlich befunden	Uneasiness	Uneasiness
An einer steilen Felsenwand;	Uneasiness	Uneasiness
Dort war ich festgebunden.	Uneasiness	Uneasiness

Der böse schmutzige Betthimmelquast!	Humor	Humor
Ich fand ihn gleichfalls wieder,	Uneasiness	Uneasiness
Doch sah er jetzt wie ein Geier aus,	Uneasiness	Uneasiness
Mit Krallen und schwarzem Gefieder.	Uneasiness	Uneasiness

Er glich dem preußischen Adler jetzt,	Uneasiness	Uneasiness
Und hielt meinen Leib umklammert;	Uneasiness	Uneasiness
Er fraß mir die Leber aus der Brust,	Uneasiness	Uneasiness
Ich habe gestöhnt und gejammert.	Uneasiness	Uneasiness

Ich jammerte lange ? da krähte der Hahn,	Humor	Sadness
Und der Fiebertraum erblaßte.	Humor	Sadness
Ich lag zu Minden im schwitzenden Bett,	Humor	Sadness
Der Adler ward wieder zum Quaste.	Humor	Humor

Ich reiste fort mit Extrapost,	Beauty / Joy	Beauty / Joy
Und schöpfte freien Odem	Beauty / Joy	Beauty / Joy
Erst draußen in der freien Natur,	Beauty / Joy	Beauty / Joy
Auf bückeburg'schem Boden.	Beauty / Joy	Beauty / Joy


Das Karussell		

Mit einem Dach und seinem Schatten dreht	Beauty / Joy	Beauty / Joy
sich eine kleine Weile der Bestand	Beauty / Joy	Beauty / Joy
von bunten Pferden, alle aus dem Land,	Beauty / Joy	Beauty / Joy
das lange zögert, eh es untergeht.	Beauty / Joy	Beauty / Joy
Zwar manche sind an Wagen angespannt,	Beauty / Joy	Beauty / Joy
doch alle haben Mut in ihren Mienen;	Beauty / Joy	Beauty / Joy
ein böser roter Löwe geht mit ihnen	Beauty / Joy	Beauty / Joy
und dann und wann ein weißer Elefant.	Beauty / Joy	Beauty / Joy

Sogar ein Hirsch ist da, ganz wie im Wald,	Beauty / Joy	Beauty / Joy --- Humor
nur dass er einen Sattel trägt und drüber	Beauty / Joy	Beauty / Joy --- Humor
ein kleines blaues Mädchen aufgeschnallt.	Beauty / Joy	Beauty / Joy --- Humor

Und auf dem Löwen reitet weiß ein Junge	Beauty / Joy	Beauty / Joy
und hält sich mit der kleinen heißen Hand	Beauty / Joy	Beauty / Joy
dieweil der Löwe Zähne zeigt und Zunge.	Beauty / Joy	Beauty / Joy
Und dann und wann ein weißer Elefant.	Beauty / Joy	Beauty / Joy

Und auf den Pferden kommen sie vorüber,	Beauty / Joy	Beauty / Joy
auch Mädchen, helle, diesem Pferdesprunge	Beauty / Joy	Beauty / Joy
fast schon entwachsen; mitten in dem Schwunge	Beauty / Joy	Beauty / Joy
schauen sie auf, irgendwohin, herüber -	Beauty / Joy	Beauty / Joy
Und dann und wann ein weißer Elefant.	Beauty / Joy	Beauty / Joy

Und das geht hin und eilt sich, dass es endet,	Vitality --- Beauty / Joy	Vitality --- Beauty / Joy
und kreist und dreht sich nur und hat kein Ziel.	Vitality --- Beauty / Joy	Vitality --- Beauty / Joy
Ein Rot, ein Grün, ein Grau vorbeigesendet,	Vitality --- Beauty / Joy	Beauty / Joy
ein kleines kaum begonnenes Profil -.	Vitality --- Beauty / Joy	Beauty / Joy
Und manchesmal ein Lächeln, hergewendet,	Vitality --- Beauty / Joy	Beauty / Joy
ein seliges, das blendet und verschwendet	Vitality --- Beauty / Joy	Beauty / Joy
an dieses atemlose blinde Spiel...	Vitality --- Beauty / Joy	Beauty / Joy


Die Tote im Wasser		

Die Masten ragen an dem grauen Wall	Uneasiness	Uneasiness
Wie ein verbrannter Wald ins frühe Rot,	Uneasiness	Uneasiness
So schwarz wie Schlacke. Wo das Wasser tot	Uneasiness	Uneasiness
Zu Speichern stiert, die morsch und im Verfall.	Uneasiness	Uneasiness

Dumpf tönt der Schall, da wiederkehrt die Flut,	Uneasiness	Vitality
Den Kai entlang. Der Stadtnacht Spülicht treibt	Uneasiness	Vitality
Wie eine weiße Haut im Strom und reibt	Uneasiness	Vitality
Sich an dem Dampfer, der im Docke ruht.	Uneasiness	Vitality

Staub, Obst, Papier, in einer dicken Schicht,	Uneasiness	Uneasiness
So treibt der Kot aus seinen Röhren ganz.	Uneasiness	Uneasiness
Ein weißes Tanzkleid kommt, in fettem Glanz	Uneasiness	Uneasiness
Ein nackter Hals und bleiweiß ein Gesicht.	Uneasiness	Uneasiness

Die Leiche wälzt sich ganz heraus. Es bläht	Uneasiness	Uneasiness
Das Kleid sich wie ein weißes Schiff im Wind.	Uneasiness	Uneasiness
Die toten Augen starren groß und blind	Uneasiness	Uneasiness
Zum Himmel, der voll rosa Wolken steht.	Uneasiness	Uneasiness

Das lila Wasser bebt von kleiner Welle.	Uneasiness	Uneasiness
- Der Wasserratten Fährte, die bemannen	Uneasiness	Uneasiness
Das weiße Schiff. Nun treibt es stolz von dannen,	Uneasiness	Uneasiness
Voll grauer Köpfe und voll schwarzer Felle.	Uneasiness	Uneasiness

Die Tote segelt froh hinaus, gerissen	Uneasiness	Uneasiness
Von Wind und Flut. Ihr dicker Bauch entragt	Uneasiness	Uneasiness
Dem Wasser groß, zerhöhlt und fast zernagt.	Uneasiness	Uneasiness
Wie eine Grotte dröhnt er von den Bissen.	Uneasiness	Uneasiness

Sie treibt ins Meer. Ihr salutiert Neptun	Uneasiness	Sadness
Von einem Wrack, da sie das Meer verschlingt,	Uneasiness --- Sadness	Sadness
Darinnen sie zur grünen Tiefe sinkt,	Uneasiness --- Sadness	Sadness
Im Arm der feisten Kraken auszuruhn.	Uneasiness --- Sadness	Sadness


Abendlied		

Am Abend, wenn wir auf dunklen Pfaden gehn,	Uneasiness --- Suspense	Suspense
Erscheinen unsere bleichen Gestalten vor uns.	Uneasiness --- Suspense	Suspense

Wenn uns dürstet,	Beauty / Joy --- Sadness	Sadness
Trinken wir die weißen Wasser des Teichs,	Beauty / Joy --- Sadness	Sadness
Die Süße unserer traurigen Kindheit.	Sadness	Sadness

Erstorbene ruhen wir unterm Hollundergebüsch,	Beauty / Joy	Sadness
Schaun den grauen Möven zu.	Beauty / Joy	Sadness

Frühlingsgewölke steigen über die finstere Stadt,	Uneasiness	Sadness
Die der Mönche edlere Zeiten schweigt.	Sadness	Sadness

Da ich deine schmalen Hände nahm	Suspense --- Sadness	Sadness
Schlugst du leise die runden Augen auf,	Suspense --- Sadness	Sadness
Dieses ist lange her.	Sadness	Sadness

Doch wenn dunkler Wohllaut die Seele heimsucht,	Beauty / Joy	Beauty / Joy --- Sadness
Erscheinst du Weiße in des Freundes herbstlicher Landschaft.	Beauty / Joy	Beauty / Joy --- Sadness


Die Dämmerung		

Ein dicker Junge spielt mit einem Teich.	Beauty / Joy	Beauty / Joy
Der Wind hat sich in einem Baum gefangen.	Beauty / Joy	Beauty / Joy
Der Himmel sieht verbummelt aus und bleich,	Beauty / Joy	Beauty / Joy --- Humor
Als wäre ihm die Schminke ausgegangen.	Beauty / Joy	Beauty / Joy --- Humor

Auf lange Krücken schief herabgebückt	Uneasiness	Humor
Und schwatzend kriechen auf dem Feld zwei Lahme.	Uneasiness	Humor
Ein blonder Dichter wird vielleicht verrückt.	Uneasiness	Humor
Ein Pferdchen stolpert über eine Dame.	Uneasiness	Humor

An einem Fenster klebt ein fetter Mann.	Uneasiness	Humor
Ein Jüngling will ein weiches Weib besuchen.	Uneasiness	Humor
Ein grauer Clown zieht sich die Stiefel an.	Uneasiness	Humor
Ein Kinderwagen schreit und Hunde fluchen.	Uneasiness	Humor


Grodek		

Am Abend tönen die herbstlichen Wälder	Uneasiness	Uneasiness
Von tötlichen Waffen, die goldnen Ebenen	Uneasiness	Uneasiness
Und blauen Seen, darüber die Sonne	Uneasiness	Uneasiness
Düster hinrollt; umfängt die Nacht	Uneasiness	Uneasiness
Sterbende Krieger, die wilde Klage	Uneasiness	Uneasiness
Ihrer zerbrochenen Münder.	Uneasiness	Uneasiness
Doch stille sammelt im Weidengrund	Uneasiness	Uneasiness
Rotes Gewölk, darin ein zürnender Gott wohnt,	Uneasiness	Uneasiness
Das vergossne Blut sich, mondne Kühle;	Uneasiness	Uneasiness
Alle Straßen münden in schwarze Verwesung.	Uneasiness	Uneasiness
Unter goldnem Gezweig der Nacht und Sternen	Sadness --- Beauty / Joy	Sadness
Es schwankt der Schwester Schatten durch den schweigenden Hain,	Sadness --- Beauty / Joy	Sadness
Zu grüßen die Geister der Helden, die blutenden Häupter;	Sadness --- Beauty / Joy	Sadness
Und leise tönen im Rohr die dunkeln Flöten des Herbstes.	Sadness --- Beauty / Joy	Sadness
O stolzere Trauer! ihr ehernen Altäre,	Sadness	Sadness
Die heiße Flamme des Geistes nährt heute ein gewaltiger Schmerz,	Sadness	Sadness
Die ungebornen Enkel.	Sadness	Sadness


Augen in der Großstadt		

Wenn du zur Arbeit gehst	Suspense	Vitality
am frühen Morgen,	Suspense	Vitality
wenn du am Bahnhof stehst	Suspense	Vitality
Mit deinen Sorgen:	Suspense	Vitality
da zeigt die Stadt	Sadness	Sadness
dir asphaltglatt	Sadness	Sadness
im Menschentrichter	Sadness	Sadness
Millionen Gesichter:	Sadness	Sadness
Zwei fremde Augen, ein kurzer Blick,	Sadness	Sadness
die Braue, Pupillen, die Lider ?	Sadness	Sadness
Was war das? vielleicht dein Lebensglück...	Sadness	Sadness
vorbei, verweht, nie wieder.	Sadness	Sadness

Du gehst dein Leben lang	Sadness	Awe / Sublime --- Sadness
auf tausend Straßen;	Sadness	Awe / Sublime --- Sadness
du siehst auf deinem Gang,	Sadness	Awe / Sublime --- Sadness
die dich vergaßen.	Sadness	Awe / Sublime --- Sadness
Ein Auge winkt,	Sadness --- Beauty / Joy	Sadness
die Seele klingt;	Sadness --- Beauty / Joy	Sadness
du hasts gefunden,	Sadness --- Beauty / Joy	Sadness
nur für Sekunden...	Sadness --- Beauty / Joy	Sadness
Zwei fremde Augen, ein kurzer Blick,	Sadness	Sadness
die Braue, Pupillen, die Lider;	Sadness	Sadness
Was war das? kein Mensch dreht die Zeit zurück...	Sadness	Sadness --- Awe / Sublime
vorbei, verweht, nie wieder.	Sadness	Sadness --- Awe / Sublime

Du mußt auf deinem Gang	Sadness	Vitality
durch Städte wandern;	Sadness	Vitality
siehst einen Pulsschlag lang	Sadness	Vitality
den fremden Andern.	Sadness	Vitality
Es kann ein Feind sein,	Sadness --- Awe / Sublime	Beauty / Joy
es kann ein Freund sein,	Sadness --- Awe / Sublime	Beauty / Joy
es kann im Kampfe dein	Sadness --- Awe / Sublime	Beauty / Joy
Genosse sein.	Sadness --- Awe / Sublime	Beauty / Joy
Er sieht hinüber	Sadness --- Awe / Sublime	Sadness
und zieht vorüber...	Sadness --- Awe / Sublime	Sadness
Zwei fremde Augen, ein kurzer Blick,	Sadness --- Awe / Sublime	Sadness
die Braue, Pupillen, die Lider.	Sadness --- Awe / Sublime	Sadness
Was war das?	Sadness --- Awe / Sublime	Sadness --- Awe / Sublime
Von der großen Menschheit ein Stück!	Sadness --- Awe / Sublime	Sadness --- Awe / Sublime
Vorbei, verweht, nie wieder.	Sadness --- Awe / Sublime	Sadness --- Awe / Sublime


Vergänglichkeit der Schönheit		

Es wird der bleiche tod mit seiner kalten hand	Sadness --- Uneasiness	Uneasiness
Dir endlich mit der zeit umb deine brüste streichen /	Sadness --- Uneasiness	Uneasiness
Der liebliche corall der lippen wird verbleichen;	Sadness	Sadness
Der schultern warmer schnee wird werden kalter sand /	Sadness	Sadness

Der ugen süsser blitz / die kräffte deiner hand /	Sadness	Sadness
Für welchen solches fällt / die werden zeitlich weichen /	Sadness	Sadness
Das haar / das itzund kan des goldes glantz erreichen /	Sadness	Sadness
Tilget endlich tag und jahr als ein gemeines band.	Sadness	Sadness

Der wohlgesetzte fuß / die lieblichen gebärden /	Sadness	Sadness
Die werden theils zu staub / theils nichts und nichtig werden /	Sadness	Sadness
Denn opfert keiner mehr der gottheit deiner pracht.	Sadness	Sadness

Diß und noch mehr als diß muß endlich untergehen /	Awe / Sublime	Beauty / Joy --- Awe / Sublime
Dein hertze kan allein zu aller zeit bestehen /	Awe / Sublime	Beauty / Joy --- Awe / Sublime
Dieweil es die natur aus diamant gemacht.	Awe / Sublime	Beauty / Joy --- Awe / Sublime


Das Landleben		

Wunderseliger Mann, welcher der Stadt entfloh!	Beauty / Joy	Beauty / Joy
Jedes Säuseln des Baums, jedes Geräusch des Bachs,	Beauty / Joy --- Awe / Sublime	Beauty / Joy
Jeder blinkende Kiesel,	Beauty / Joy --- Awe / Sublime	Beauty / Joy
Predigt Tugend und Weisheit ihm!	Beauty / Joy --- Awe / Sublime	Beauty / Joy

Jedes Schattengesträuch ist ihm ein heiliger	Beauty / Joy --- Awe / Sublime	Beauty / Joy
Tempel, wo ihm sein Gott näher vorüberwallt;	Beauty / Joy --- Awe / Sublime	Beauty / Joy
Jeder Rasen ein Altar,	Beauty / Joy --- Awe / Sublime	Beauty / Joy
Wo er vor dem Erhabnen kniet.	Beauty / Joy --- Awe / Sublime	Beauty / Joy

Seine Nachtigall tönt Schlummer herab auf ihn,	Beauty / Joy	Beauty / Joy
Seine Nachtigall weckt flötend ihn wieder auf,	Beauty / Joy	Beauty / Joy
Wenn das liebliche Frühroth	Beauty / Joy	Beauty / Joy
Durch die Bäum' auf sein Bette scheint.	Beauty / Joy	Beauty / Joy

Dann bewundert er dich, Gott, in der Morgenflur,	Awe / Sublime --- Beauty / Joy	Beauty / Joy --- Awe / Sublime
In der steigenden Pracht deiner Verkünderin,	Awe / Sublime --- Beauty / Joy	Beauty / Joy --- Awe / Sublime
Der allherrlichen Sonne,	Awe / Sublime --- Beauty / Joy	Beauty / Joy --- Awe / Sublime
Dich im Wurm, und im Knospenzweig.	Awe / Sublime --- Beauty / Joy	Beauty / Joy --- Awe / Sublime

Ruht im wehenden Gras, wann sich die Kühl' ergießt,	Beauty / Joy	Beauty / Joy
Oder strömet den Quell über die Blumen aus;	Beauty / Joy	Beauty / Joy
Trinkt den Athem der Blüthe,	Beauty / Joy	Beauty / Joy
Trinkt die Milde der Abendluft.	Beauty / Joy	Beauty / Joy

Sein bestrohetes Dach, wo sich das Taubenvolk	Beauty / Joy	Beauty / Joy
Sonnt, und spielet und hüpft, winket ihm süßre Rast,	Beauty / Joy	Beauty / Joy
Als dem Städter der Goldsaal,	Beauty / Joy	Beauty / Joy
Als der Polster der Städterin.	Beauty / Joy	Beauty / Joy

Und der spielende Trupp schwirret zu ihm herab,	Vitality	Beauty / Joy
Gurrt und säuselt ihn an, flattert ihm auf den Korb;	Vitality	Beauty / Joy
Picket Krumen und Erbsen,	Vitality	Beauty / Joy
Picket Körner ihm aus der Hand.	Vitality	Beauty / Joy

Einsam wandelt er oft, Sterbegedanken voll,	Sadness	Sadness
Durch die Gräber des Dorfs, sezet sich auf ein Grab,	Sadness	Sadness
Und beschauet die Kreuze,	Sadness	Sadness
Und den wehenden Todtenkranz.	Sadness	Sadness

Wunderseliger Mann, welcher der Stadt entfloh!	Beauty / Joy	Beauty / Joy
Engel segneten ihn, als er geboren ward,	Beauty / Joy	Beauty / Joy
Streuten Blumen des Himmels	Beauty / Joy	Beauty / Joy
Auf die Wiege des Knaben aus.	Beauty / Joy	Beauty / Joy


Willkommen und Abschied / Es schlug mein Herz		

Es schlug mein Herz, geschwind zu Pferde!	Vitality	Suspense
Es war getan fast eh gedacht;	Vitality	Suspense
Der Abend wiegte schon die Erde	Beauty / Joy	Beauty / Joy
Und an den Bergen hing die Nacht	Beauty / Joy	Beauty / Joy
Schon stand im Nebelkleid die Eiche	Beauty / Joy	Uneasiness
Ein aufgetürmter Riese, da,	Uneasiness	Uneasiness
Wo Finsternis aus dem Gesträuche	Uneasiness	Uneasiness
Mit hundert schwarzen Augen sah.	Uneasiness	Uneasiness

Der Mond von einem Wolkenhügel	Beauty / Joy --- Uneasiness	Uneasiness
Sah kläglich aus dem Duft hervor;	Beauty / Joy --- Uneasiness	Uneasiness
Die winde schwangen leise Flügel	Beauty / Joy --- Uneasiness	Uneasiness
Umsausten schauerlich mein Ohr	Uneasiness	Uneasiness
Die Nacht schuf tausend Ungeheuer	Uneasiness	Uneasiness
Doch frisch und fröhlich war mein Mut	Vitality	Vitality --- Beauty / Joy
In meinen Adern welches Feuer!	Vitality	Vitality --- Beauty / Joy
In meinen Herzen welche Glut!	Vitality	Vitality --- Beauty / Joy

Dich sah ich, und die milde Freude	Beauty / Joy	Beauty / Joy
Floß von dem süßen Blick auf mich;	Beauty / Joy	Beauty / Joy
Ganz war mein Herz an deiner Seite	Beauty / Joy	Beauty / Joy
Und jeder Atemzug für dich.	Beauty / Joy	Beauty / Joy
Ein rosafarbenes Frühlingswetter	Beauty / Joy	Beauty / Joy
Umgab das liebliche Gesicht,	Beauty / Joy	Beauty / Joy
Und Zärtlichkeit für mich - ihr Götter!	Vitality --- Beauty / Joy	Beauty / Joy
Ich hofft es, ich verdient es nicht!	Vitality --- Beauty / Joy	Beauty / Joy

Doch, ach schon mit der Morgensonne	Sadness	Sadness
Verengt der Abschied mir das Herz	Sadness	Sadness
In deinen Küssen welche Wonne!	Sadness	Sadness
In deinem Auge welcher Schmerz!	Sadness	Beauty / Joy
Ich ging und du standst und sahst zu Erden	Sadness	Sadness
Und sahst mir nach mit nassen Blick:	Sadness	Sadness
Und doch welch Glück geliebt zu werden!	Vitality --- Awe / Sublime	Awe / Sublime --- Beauty / Joy
Und lieben, Götter, welch ein Glück!	Vitality --- Awe / Sublime	Awe / Sublime --- Beauty / Joy


Frühling		

Frühling soll mit süßen Blicken	Beauty / Joy	Beauty / Joy --- Vitality
Mich entzücken und berücken,	Beauty / Joy	Beauty / Joy --- Vitality
Sommer mich mit Frucht und Myrthen	Beauty / Joy	Beauty / Joy --- Vitality
Reich bewirten, froh umgürten.	Beauty / Joy	Beauty / Joy --- Vitality

Herbst, du sollst mich Haushalt lehren,	Beauty / Joy	Vitality
Zu entbehren, zu begehren,	Beauty / Joy	Vitality
Und du Winter lehr mich sterben,	Beauty / Joy --- Sadness	Vitality
Mich verderben, Frühling erben.	Beauty / Joy --- Sadness	Vitality


Grenzen der Menschheit		

Wenn der uralte,	Awe / Sublime	Awe / Sublime
Heilige Vater	Awe / Sublime	Awe / Sublime
Mit gelassener Hand	Awe / Sublime	Awe / Sublime
Aus rollenden Wolken	Awe / Sublime	Awe / Sublime
Segnende Blitze	Awe / Sublime	Awe / Sublime
Über die Erde sät	Awe / Sublime	Awe / Sublime
Küss ich den letzten	Awe / Sublime	Awe / Sublime
Saum seines Kleides,	Awe / Sublime	Awe / Sublime
Kindliche Schauer	Awe / Sublime	Awe / Sublime
Treu in der Brust.	Awe / Sublime	Awe / Sublime

Denn mit Göttern	Beauty / Joy	Vitality
Soll sich nicht messen	Beauty / Joy --- Uneasiness	Vitality
Irgend ein Mensch.	Beauty / Joy --- Uneasiness	Vitality
Hebt er sich aufwärts	Beauty / Joy --- Uneasiness	Beauty / Joy
Und berührt	Beauty / Joy --- Uneasiness	Beauty / Joy
Mit dem Scheitel die Sterne,	Beauty / Joy --- Uneasiness	Beauty / Joy
Nirgends haften dann	Beauty / Joy --- Uneasiness	Beauty / Joy
Die unsichern Sohlen,	Beauty / Joy --- Uneasiness	Beauty / Joy
Und mit ihm spielen	Beauty / Joy --- Uneasiness	Beauty / Joy
Wolken und Winde.	Beauty / Joy --- Uneasiness	Beauty / Joy

Steht er mit festen,	Beauty / Joy	Beauty / Joy
Markigen Knochen	Beauty / Joy	Beauty / Joy
Auf der wohlgegründeten	Beauty / Joy	Beauty / Joy
Dauernden Erde,	Beauty / Joy	Beauty / Joy
Reicht er nicht auf,	Beauty / Joy	Beauty / Joy
Nur mit der Eiche	Beauty / Joy	Beauty / Joy
Oder der Rebe	Beauty / Joy	Beauty / Joy
Sich zu vergleichen.	Beauty / Joy	Beauty / Joy

Was underscheidet	Awe / Sublime	Beauty / Joy --- Awe / Sublime
Götter von Menschen?	Awe / Sublime	Beauty / Joy --- Awe / Sublime
Daß viele Wellen	Awe / Sublime	Beauty / Joy --- Awe / Sublime
Vor jenen wandeln,	Awe / Sublime	Beauty / Joy --- Awe / Sublime
Ein ewiger Strom:	Awe / Sublime	Beauty / Joy --- Awe / Sublime
Uns hebt die Welle,	Awe / Sublime --- Sadness	Beauty / Joy --- Awe / Sublime
Verschlingt die Welle,	Awe / Sublime --- Sadness	Beauty / Joy --- Awe / Sublime
Und wir versinken.	Awe / Sublime --- Sadness	Beauty / Joy --- Awe / Sublime

Ein kleiner Ring	Awe / Sublime	Awe / Sublime
Begrenzt unser Leben,	Awe / Sublime	Awe / Sublime
Und viele Geschlechter	Awe / Sublime	Awe / Sublime
Reihen sie dauernd,	Awe / Sublime	Awe / Sublime
An ihres Daseins	Awe / Sublime	Awe / Sublime
Unendliche Kette.	Awe / Sublime	Awe / Sublime


Lebenslauf		

Größers wolltest auch du, aber die Liebe zwingt	Sadness	Sadness
All uns nieder, das Leid beuget gewaltiger,	Sadness	Sadness
Doch es kehret umsonst nicht	Sadness	Sadness
Unser Bogen, woher er kommt.	Sadness	Sadness

Aufwärts oder hinab! herrschet in heilger Nacht,	Sadness	Sadness
Wo die stumme Natur werdende Tage sinnt,	Sadness	Sadness
Herrscht im schiefesten Orkus	Sadness	Sadness
Nicht ein Grades, ein Recht noch auch?	Sadness	Sadness

Dies erfuhr ich. Denn nie, sterblichen Meistern gleich,	Sadness	Sadness --- Annoyance
Habt ihr Himmlischen, ihr Alleserhaltenden,	Sadness	Sadness --- Annoyance
Daß ich wüßte, mit Vorsicht	Sadness	Sadness --- Annoyance
Mich des ebenen Pfads geführt.	Sadness	Sadness --- Annoyance

Alles prüfe der Mensch, sagen die Himmlischen,	Awe / Sublime	Vitality --- Awe / Sublime
Daß er, kräftig genährt, danken für Alles lern',	Awe / Sublime	Vitality --- Awe / Sublime
Und verstehe die Freiheit,	Awe / Sublime	Vitality --- Awe / Sublime
Aufzubrechen, wohin er will.	Awe / Sublime	Vitality --- Awe / Sublime


An die Welt		

Mein oft bestürmtes Schiff, der grimmen Winde Spiel,	Beauty / Joy --- Vitality	Beauty / Joy
Der frechen Wellen Ball, das schier die Flut getrennet,	Beauty / Joy --- Vitality	Beauty / Joy
Das über Klipp' auf Klipp' und Schaum und Sand gerennet,	Beauty / Joy --- Vitality	Beauty / Joy
Kommt vor der zeit an' Port, den meine Seele will.	Beauty / Joy --- Vitality	Beauty / Joy

Oft, wenn uns schwarze Nacht im Mittag überfiel,	Uneasiness	Uneasiness
Hat der geschwinde Blitz die Segel schier verbrennet!	Uneasiness	Uneasiness
Wie oft hab' ich den Wind und Nord und Süd verkennet!	Uneasiness	Uneasiness
Wie schadhaft ist der Mast, Steu'rruder, Schwert und Kiel.	Uneasiness	Uneasiness

Steig aus, du müder Geist! Steig aus! Wir sind am Lande!	Vitality	Vitality
Was graut dir für dem Port? Jetzt wirst du aller Bande	Vitality	Vitality
Und Angst und herber Pein und schwerer Schmerzen los.	Vitality	Vitality

Ade, verfluchte Welt. Du See voll rauher Stürme:	Beauty / Joy --- Awe / Sublime	Vitality --- Beauty / Joy
Glück zu, mein Vaterland, das stete Ruh' im Schirme	Beauty / Joy --- Awe / Sublime	Vitality --- Beauty / Joy
Und Schutz und Frieden hält, du ewiglichtes Schloß!	Beauty / Joy --- Awe / Sublime	Vitality --- Beauty / Joy


Im Abendrot		

Wir sind durch Not und Freude	Beauty / Joy	Beauty / Joy
Gegangen Hand in Hand,	Beauty / Joy	Beauty / Joy
Vom Wandern ruhen wir beide	Beauty / Joy	Beauty / Joy
Nun überm stillen Land.	Beauty / Joy	Beauty / Joy

Rings sich die Täler neigen,	Beauty / Joy	Beauty / Joy
Es dunkelt schon die Luft,	Beauty / Joy --- Suspense	Beauty / Joy
Zwei Lerchen nur noch steigen	Beauty / Joy	Beauty / Joy
Nachträumend in den Duft.	Beauty / Joy	Beauty / Joy

Tritt her und laß sie schwirren,	Suspense	Vitality
Bald ist es Schlafenszeit,	Suspense	Vitality
Daß wir uns nicht verirren	Suspense --- Uneasiness	Vitality
In dieser Einsamkeit.	Suspense --- Uneasiness	Vitality

O weiter, stiller Friede!	Beauty / Joy	Beauty / Joy
So tief im Abendrot ,	Beauty / Joy	Beauty / Joy
Wie sind wir wandermüde ?	Beauty / Joy	Beauty / Joy
Ist das etwa der Tod?	Beauty / Joy --- Uneasiness	Beauty / Joy


Deutschland. Ein Wintermärchen, Caput 7 / VII		

Ich ging nach Haus und schlief, als ob	Beauty / Joy	Beauty / Joy
Die Engel gewiegt mich hätten.	Beauty / Joy	Beauty / Joy
Man ruht in deutschen Betten so weich,	Beauty / Joy	Beauty / Joy --- Humor
Denn das sind Federbetten.	Beauty / Joy	Beauty / Joy --- Humor

Wie sehnt ich mich oft nach der Süßigkeit	Beauty / Joy	Sadness
Des vaterländischen Pfühles,	Beauty / Joy	Sadness
Wenn ich auf harten Matratzen lag,	Beauty / Joy	Sadness
In der schlaflosen Nacht des Exiles!	Beauty / Joy	Sadness

Man schläft sehr gut und träumt auch gut	Beauty / Joy	Beauty / Joy --- Humor
In unseren Federbetten.	Beauty / Joy	Beauty / Joy --- Humor
Hier fühlt die deutsche Seele sich frei	Beauty / Joy	Beauty / Joy
Von allen Erdenketten.	Beauty / Joy	Beauty / Joy

Sie fühlt sich frei und schwingt sich empor	Beauty / Joy	Beauty / Joy
Zu den höchsten Himmelsräumen.	Beauty / Joy	Beauty / Joy
O deutsche Seele, wie stolz ist dein Flug	Beauty / Joy	Beauty / Joy
In deinen nächtlichen Träumen!	Beauty / Joy	Beauty / Joy

Die Götter erbleichen, wenn du nahst!	Humor	Suspense
Du hast auf deinen Wegen	Humor	Suspense --- Beauty / Joy
Gar manches Sternlein ausgeputzt	Humor	Suspense --- Beauty / Joy
Mit deinen Flügelschlägen!	Humor	Suspense --- Beauty / Joy

Franzosen und Russen gehört das Land,	Humor	Suspense
Das Meer gehört den Briten,	Humor	Suspense
Wir aber besitzen im Luftreich des Traums	Humor	Suspense
Die Herrschaft unbestritten.	Humor	Suspense

Hier üben wir die Hegemonie,	Humor	Suspense
Hier sind wir unzerstückelt;	Humor	Suspense
Die andern Völker haben sich	Humor	Suspense
Auf platter Erde entwickelt. ? ?	Humor	Suspense

Und als ich einschlief, da träumte mir,	Suspense	Beauty / Joy
Ich schlenderte wieder im hellen	Suspense	Beauty / Joy
Mondschein die hallenden Straßen entlang,	Suspense	Beauty / Joy
In dem altertümlichen Köllen.	Suspense	Beauty / Joy

Und hinter mir ging wieder einher	Uneasiness	Uneasiness
Mein schwarzer, vermummter Begleiter.	Uneasiness	Uneasiness
Ich war so müde, mir brachen die Knie,	Uneasiness	Uneasiness
Doch immer gingen wir weiter.	Uneasiness	Uneasiness

Wir gingen weiter. Mein Herz in der Brust	Uneasiness	Uneasiness
War klaffend aufgeschnitten,	Uneasiness	Uneasiness
Und aus der Herzenswunde hervor	Uneasiness	Uneasiness
Die roten Tropfen glitten.	Uneasiness	Uneasiness

Ich tauchte manchmal die Finger hinein,	Uneasiness	Uneasiness
Und manchmal ist es geschehen,	Uneasiness	Uneasiness
Daß ich die Haustürpfosten bestrich	Uneasiness	Uneasiness
Mit dem Blut im Vorübergehen.	Uneasiness	Uneasiness

Und jedesmal, wenn ich ein Haus	Sadness --- Uneasiness	Sadness
Bezeichnet in solcher Weise,	Sadness --- Uneasiness	Sadness
Ein Sterbeglöckchen erscholl fernher,	Sadness --- Uneasiness	Sadness
Wehmütig wimmernd und leise.	Sadness --- Uneasiness	Sadness

Am Himmel aber erblich der Mond,	Uneasiness	Uneasiness
Er wurde immer trüber;	Uneasiness	Uneasiness
Gleich schwarzen Rossen jagten an ihm	Uneasiness	Uneasiness
Die wilden Wolken vorüber.	Uneasiness	Uneasiness

Und immer ging hinter mir einher	Uneasiness	Uneasiness
Mit seinem verborgenen Beile	Uneasiness	Uneasiness
Die dunkle Gestalt ? so wanderten wir	Uneasiness	Uneasiness
Wohl eine gute Weile.	Uneasiness	Uneasiness

Wir gehen und gehen, bis wir zuletzt	Suspense	Suspense
Wieder zum Domplatz gelangen;	Suspense	Suspense
Weit offen standen die Pforten dort,	Suspense	Suspense
Wir sind hineingegangen.	Suspense	Suspense

Es herrschte im ungeheuren Raum	Uneasiness	Suspense --- Uneasiness
Nur Tod und Nacht und Schweigen;	Uneasiness	Suspense --- Uneasiness
Es brannten Ampeln hie und da,	Uneasiness	Suspense --- Uneasiness
Um die Dunkelheit recht zu zeigen.	Uneasiness	Suspense --- Uneasiness

Ich wandelte lange den Pfeilern entlang	Uneasiness	Uneasiness --- Suspense
Und hörte nur die Tritte	Uneasiness	Uneasiness --- Suspense
Von meinem Begleiter, er folgte mir	Uneasiness	Uneasiness --- Suspense
Auch hier bei jedem Schritte.	Uneasiness	Uneasiness --- Suspense

Wir kamen endlich zu einem Ort,	Beauty / Joy	Beauty / Joy
Wo funkelnde Kerzenhelle	Beauty / Joy	Beauty / Joy
Und blitzendes Gold und Edelstein;	Beauty / Joy	Beauty / Joy
Das war die Drei-Königs-Kapelle.	Beauty / Joy	Beauty / Joy

Die Heil'gen Drei Könige jedoch,	Uneasiness --- Suspense	Suspense
Die sonst so still dort lagen,	Uneasiness --- Suspense	Suspense
O Wunder! sie saßen aufrecht jetzt	Uneasiness --- Suspense	Suspense
Auf ihren Sarkophagen.	Uneasiness --- Suspense	Suspense

Drei Totengerippe, phantastisch geputzt,	Uneasiness	Beauty / Joy
Mit Kronen auf den elenden	Uneasiness	Beauty / Joy
Vergilbten Schädeln, sie trugen auch	Uneasiness	Beauty / Joy
Das Zepter in knöchernen Händen.	Uneasiness	Beauty / Joy

Wie Hampelmänner bewegten sie	Uneasiness	Beauty / Joy
Die längstverstorbenen Knochen;	Uneasiness	Beauty / Joy
Die haben nach Moder und zugleich	Uneasiness	Beauty / Joy
Nach Weihrauchduft gerochen.	Uneasiness	Beauty / Joy

Der eine bewegte sogar den Mund	Humor	Beauty / Joy --- Humor
Und hielt eine Rede, sehr lange;	Humor	Beauty / Joy --- Humor
Er setzte mir auseinander, warum	Humor	Beauty / Joy --- Humor
Er meinen Respekt verlange.	Humor	Beauty / Joy --- Humor

Zuerst weil er ein Toter sei,	Humor	Humor --- Beauty / Joy
Und zweitens weil er ein König,	Humor	Humor --- Beauty / Joy
Und drittens weil er ein Heil'ger sei ?	Humor	Humor --- Beauty / Joy
Das alles rührte mich wenig.	Humor	Humor --- Beauty / Joy

Ich gab ihm zur Antwort lachenden Muts:	Humor	Humor --- Beauty / Joy
»Vergebens ist deine Bemühung!	Humor	Humor --- Beauty / Joy
Ich sehe, daß du der Vergangenheit	Humor	Humor --- Beauty / Joy
Gehörst in jeder Beziehung.	Humor	Humor --- Beauty / Joy

Fort! fort von hier! im tiefen Grab	Vitality --- Humor	Humor
Ist eure natürliche Stelle.	Vitality --- Humor	Humor
Das Leben nimmt jetzt in Beschlag	Vitality --- Humor	Humor
Die Schätze dieser Kapelle.	Vitality --- Humor	Humor

Der Zukunft fröhliche Kavallerie	Vitality --- Humor	Humor
Soll hier im Dome hausen,	Vitality --- Humor	Humor
Und weicht ihr nicht willig, so brauch ich Gewalt	Vitality --- Humor	Humor
Und laß euch mit Kolben lausen!«	Vitality --- Humor	Humor

So sprach ich, und ich drehte mich um,	Suspense	Suspense
Da sah ich furchtbar blinken	Suspense	Suspense
Des stummen Begleiters furchtbares Beil ?	Suspense	Suspense
Und er verstand mein Winken.	Suspense	Suspense

Er nahte sich, und mit dem Beil	Uneasiness	Uneasiness
Zerschmetterte er die armen	Uneasiness	Uneasiness
Skelette des Aberglaubens, er schlug	Uneasiness	Uneasiness
Sie nieder ohn' Erbarmen.	Uneasiness	Uneasiness

Es dröhnte der Hiebe Widerhall	Uneasiness	Uneasiness
Aus allen Gewölben, entsetzlich! ?	Uneasiness	Uneasiness
Blutströme schossen aus meiner Brust,	Uneasiness	Uneasiness
Und ich erwachte plötzlich.	Uneasiness	Uneasiness


Zwei Segel		

Zwei Segel erhellend	Vitality --- Beauty / Joy	Beauty / Joy
Die tiefblaue Bucht!	Vitality --- Beauty / Joy	Beauty / Joy
Zwei Segel sich schwellend	Vitality --- Beauty / Joy	Beauty / Joy
Zu ruhiger Flucht!	Vitality --- Beauty / Joy	Beauty / Joy

Wie eins in den Winden	Vitality --- Beauty / Joy	Beauty / Joy
Sich wölbt und bewegt,	Vitality --- Beauty / Joy	Beauty / Joy
Wird auch das Empfinden	Vitality --- Beauty / Joy	Beauty / Joy
Des andern erregt.	Vitality --- Beauty / Joy	Beauty / Joy

Begehrt eins zu hasten,	Vitality --- Beauty / Joy	Beauty / Joy --- Vitality
Das andre geht schnell,	Vitality --- Beauty / Joy	Beauty / Joy --- Vitality
Verlangt eins zu rasten,	Vitality --- Beauty / Joy	Beauty / Joy --- Vitality
Ruht auch sein Gesell.	Vitality --- Beauty / Joy	Beauty / Joy --- Vitality


Ein alter Tibetteppich		

Deine Seele, die die meine liebet,	Beauty / Joy --- Awe / Sublime	Beauty / Joy
Ist verwirkt mit ihr im Teppichtibet.	Beauty / Joy --- Awe / Sublime	Beauty / Joy

Strahl in Strahl, verliebte Farben,	Beauty / Joy	Beauty / Joy
Sterne, die sich himmellang umwarben.	Beauty / Joy	Beauty / Joy

Unsere Füße ruhen auf der Kostbarkeit,	Beauty / Joy	Beauty / Joy
Maschentausendabertausendweit.	Beauty / Joy	Beauty / Joy

Süßer Lamasohn auf Moschuspflanzenthron,	Beauty / Joy	Beauty / Joy
Wie lange küßt Dein Mund den meinen wohl	Beauty / Joy	Beauty / Joy
Und Wang die Wange buntgeknüpfte Zeiten schon?	Beauty / Joy	Beauty / Joy


Nach der Schlacht		

In Maiensaaten liegen eng die Leichen,	Annoyance --- Sadness	Sadness
Im grünen Rain, auf Blumen, ihren Betten.	Annoyance --- Sadness	Sadness
Verlorne Waffen, Räder ohne Speichen,	Annoyance	Suspense
Und umgestürzt die eisernen Lafetten.	Annoyance	Suspense

Aus vielen Pfützen dampft des Blutes Rauch,	Uneasiness	Uneasiness
Die schwarz und rot den braunen Feldweg decken.	Uneasiness	Uneasiness
Und weißlich quillt der toten Pferde Bauch,	Uneasiness	Uneasiness
Die ihre Beine in die Frühe strecken.	Uneasiness	Uneasiness

Im kühlen Winde friert noch das Gewimmer	Sadness	Sadness
Von Sterbenden, da in des Osten Tore	Sadness	Sadness
Ein blasser Glanz erscheint, ein grüner Schimmer,	Sadness	Sadness
Das dünne Band der flüchtigen Aurore	Sadness	Sadness


Auf der Terrasse des Café Josty		

Der Potsdamer Platz in ewigem Gebrüll	Vitality	Vitality
Vergletschert alle hallenden Lawinen	Vitality	Vitality
Der Straßentrakte: Trams auf Eisenschienen,	Vitality	Vitality
Automobile und den Menschenmüll.	Vitality	Vitality

Die Menschen rinnen über den Asphalt,	Vitality	Vitality --- Beauty / Joy
Ameisenemsig, wie Eidechsen flink.	Vitality	Vitality --- Beauty / Joy
Stirne und Hände, von Gedanken blink,	Vitality	Beauty / Joy --- Vitality
Schwimmen wie Sonnenlicht durch dunklen Wald.	Vitality	Beauty / Joy --- Vitality

Nachtregen hüllt den Platz in eine Höhle,	Beauty / Joy	Beauty / Joy
Wo Fledermäuse, weiß, mit Flügeln schlagen	Beauty / Joy	Beauty / Joy
Und lila Quallen liegen - bunte Öle;	Beauty / Joy	Beauty / Joy

Die mehren sich, zerschnitten von den Wagen. -	Uneasiness	Uneasiness
Aufspritzt Berlin, des Tages glitzernd Nest,	Uneasiness	Uneasiness
Vom Rauch der Nacht wie Eiter einer Pest.	Uneasiness	Uneasiness


Die Raben		

Über den schwarzen Winkel hasten	Uneasiness	Uneasiness
Am Mittag die Raben mit hartem Schrei.	Uneasiness	Uneasiness
Ihr Schatten streift an der Hirschkuh vorbei	Uneasiness	Uneasiness
Und manchmal sieht man sie mürrisch rasten.	Uneasiness	Uneasiness

O wie sie die braune Stille stören,	Uneasiness	Uneasiness
In der ein Acker sich verzückt,	Uneasiness	Uneasiness
Wie ein Weib, das schwere Ahnung berückt,	Uneasiness	Uneasiness
Und manchmal kann man sie keifen hören	Uneasiness	Uneasiness

Um ein Aas, das sie irgendwo wittern,	Uneasiness	Uneasiness
Und plötzlich richten nach Nord sie den Flug	Uneasiness	Uneasiness
Und schwinden wie ein Leichenzug	Uneasiness	Uneasiness
In Lüften, die von Wollust zittern.	Uneasiness	Uneasiness


Morgens		

Ein starker Wind sprang empor.	Uneasiness	Uneasiness
Öffnet des eisernen Himmels blutende Tore.	Uneasiness	Uneasiness
Schlägt an die Türme.	Uneasiness	Uneasiness
Hellklingend laut geschmeidig über die eherne Ebene der Stadt.	Beauty / Joy	Beauty / Joy
Die Morgensonne rußig. Auf Dämmen donnern Züge.	Beauty / Joy	Beauty / Joy
Durch Wolken pflügen goldne Engelpflüge.	Beauty / Joy	Beauty / Joy
Starker Wind über der bleichen Stadt.	Uneasiness	Beauty / Joy
Dampfer und Kräne erwachen am schmutzig fließenden Strom.	Uneasiness	Beauty / Joy
Verdrossen klopfen die Glocken am verwitterten Dom.	Uneasiness	Beauty / Joy
Viele Weiber siehst du und Mädchen zur Arbeit gehn.	Vitality	Vitality
Im bleichen Licht. Wild von der Nacht. Ihre Röcke wehn.	Vitality	Vitality
Glieder zur Liebe geschaffen.	Vitality	Vitality --- Annoyance
Hin zur Maschine und mürrischem Mühn.	Vitality	Vitality --- Annoyance
Sieh in das zärtliche Licht.	Vitality	Vitality --- Beauty / Joy
In der Bäume zärtliches Grün.	Vitality	Vitality --- Beauty / Joy
Horch! Die Spatzen schrein.	Vitality	Vitality --- Beauty / Joy
Und draußen auf wilderen Feldern	Vitality	Vitality --- Beauty / Joy
singen Lerchen.	Vitality	Vitality --- Beauty / Joy


Deutschland im Marschschritt		

Wenn wir marschieren - Schritt um Schritt -	Vitality	Vitality
Wir lauschen: unser Herz schlägt mit.	Vitality	Vitality
Mein Herz und dein Herz, Kamerad.	Vitality	Vitality
Im gleichen Takt: Soldat! Soldat!	Vitality	Vitality

So Reih um Reihe - Schritt um Schritt -	Vitality	Vitality
Kolonnen stampfen gleichen Tritt.	Vitality	Vitality
Wir ahnen's groß, wir beten's schon:	Vitality	Vitality
Dies ist der Pulsschlag der Nation.	Vitality	Vitality

Wenn wir marschieren - Schritt um Schritt -	Vitality	Vitality
In unsrem Blute ziehen mit	Vitality	Vitality
Die Väter all, die Enkel schon:	Vitality	Vitality
Im ewigen Pulsschlag der Nation.	Vitality	Vitality

Soldat! Soldat! So Tritt um Tritt.	Annoyance --- Vitality	Vitality
Hört Deutschland, wie es stritt und litt!	Annoyance --- Vitality	Vitality
Hört Deutschland, wie es ewig zieht,	Annoyance --- Vitality	Vitality
Das beste Blut, ins Heldenlied!	Annoyance --- Vitality	Vitality


Venus / Denn lieben ist nichts mehr - als eine schifferey		

Denn lieben ist nichts mehr/ als eine schifferey/	Beauty / Joy --- Awe / Sublime	Awe / Sublime --- Sadness
Das schiff ist unser hertz/ den seilen kommen bey	Beauty / Joy --- Awe / Sublime	Awe / Sublime --- Sadness
Die sinn-verwirrungen. Das meer ist unser leben/	Beauty / Joy --- Awe / Sublime	Awe / Sublime --- Sadness
Die liebes-wellen sind die angst/ in der wir schweben/	Beauty / Joy --- Awe / Sublime	Awe / Sublime --- Sadness

Die segel/ wo hinein bläst der begierden wind/	Beauty / Joy	Awe / Sublime --- Beauty / Joy
Ist der gedancken tuch. Verlangen/ hoffnung sind	Beauty / Joy	Awe / Sublime --- Beauty / Joy
Die ancker. Der magnet ist schönheit. Unser strudel	Beauty / Joy	Awe / Sublime --- Beauty / Joy
Sind Bathseben. Der wein und überfluß die rudel.	Beauty / Joy	Awe / Sublime --- Beauty / Joy

Der stern/ nach welchem man die steiffen segel lenckt/	Beauty / Joy	Awe / Sublime --- Beauty / Joy
Ist ein benelckter mund. Der port/ wohin man denckt/	Beauty / Joy	Awe / Sublime --- Beauty / Joy
Ist eine schöne frau. Die ufer sind die brüste.	Beauty / Joy	Awe / Sublime --- Beauty / Joy
Die anfahrt ist ein kuß. Der zielzweck/ süsse lüste.	Beauty / Joy	Awe / Sublime --- Beauty / Joy

Wird aber hier umwölckt/ durch blinder brünste rauch	Sadness	Sadness --- Awe / Sublime
Die sonne der vernunfft/ so folgt der schiffbruch auch	Sadness	Sadness --- Awe / Sublime
Der seelen untergang/ und der verderb des leibes:	Sadness	Sadness --- Awe / Sublime
Denn beyde tödtet uns der lustbrauch eines weibes.	Sadness	Sadness --- Awe / Sublime


Neue Liebe, neues Leben		

Herz, mein Herz, was soll das geben?	Vitality	Vitality
Was bedränget dich so sehr?	Vitality	Vitality
Welch ein fremdes, neues Leben!	Vitality	Vitality
Ich erkenne dich nicht mehr.	Vitality	Vitality
Weg ist alles, was du liebtest,	Vitality	Vitality
Weg, warum du dich betrübtest,	Vitality	Vitality
Weg dein Fleiß und deine Ruh ?	Vitality	Vitality
Ach, wie kamst du nur dazu!	Vitality	Vitality

Fesselt dich die Jugendblüte,	Beauty / Joy	Beauty / Joy
Diese liebliche Gestalt,	Beauty / Joy	Beauty / Joy
Dieser Blick voll Treu und Güte	Beauty / Joy	Beauty / Joy
Mit unendlicher Gewalt?	Beauty / Joy	Beauty / Joy
Will ich rasch mich ihr entziehen,	Sadness --- Beauty / Joy	Beauty / Joy
Mich ermannen, ihr entfliehen,	Sadness --- Beauty / Joy	Beauty / Joy
Führet mich im Augenblick,	Sadness --- Beauty / Joy	Beauty / Joy
Ach, mein Weg zu ihr zurück.	Sadness --- Beauty / Joy	Beauty / Joy

Und an diesem Zauberfädchen,	Sadness --- Beauty / Joy	Beauty / Joy
Das sich nicht zerreißen lässt,	Sadness --- Beauty / Joy	Beauty / Joy
Hält das liebe lose Mädchen	Sadness --- Beauty / Joy	Beauty / Joy
Mich so wider Willen fest;	Sadness --- Beauty / Joy	Beauty / Joy
Muss in ihrem Zauberkreise	Sadness --- Beauty / Joy	Beauty / Joy --- Vitality
Leben nun auf ihre Weise.	Sadness --- Beauty / Joy	Beauty / Joy --- Vitality
Die Verändrung, ach, wie groß!	Sadness --- Beauty / Joy	Beauty / Joy --- Vitality
Liebe! Liebe! Lass mich los!	Sadness --- Beauty / Joy	Beauty / Joy --- Vitality


Die Teilung der Erde		

»Nehmt hin die Welt!« rief Zeus von seinen Höhen	Vitality --- Suspense	Suspense
Den Menschen zu. »Nehmt, sie soll euer sein!	Vitality --- Suspense	Suspense
Euch schenk ich sie zum Erb und ewgen Lehen -	Vitality --- Suspense	Suspense
Doch teilt euch brüderlich darein!«	Vitality --- Suspense	Suspense

Da eilt', was Hände hat, sich einzurichten,	Vitality	Beauty / Joy
Es regte sich geschäftig jung und alt.	Vitality	Beauty / Joy
Der Ackermann griff nach des Feldes Früchten,	Vitality	Beauty / Joy
Der Junker birschte durch den Wald.	Vitality	Beauty / Joy

Der Kaufmann nimmt, was seine Speicher fassen,	Annoyance	Beauty / Joy
Der Abt wählt sich den edeln Firnewein,	Annoyance	Beauty / Joy
Der König sperrt die Brücken und die Straßen	Annoyance	Beauty / Joy
Und sprach: »Der Zehente ist mein.«	Annoyance	Beauty / Joy

Ganz spät, nachdem die Teilung längst geschehen,	Sadness --- Suspense	Suspense
Naht der Poet, er kam aus weiter Fern -	Sadness --- Suspense	Suspense
Ach! da war überall nichts mehr zu sehen,	Sadness --- Suspense	Suspense --- Humor
Und alles hatte seinen Herrn!	Sadness --- Suspense	Suspense --- Humor

»Weh mir! So soll denn ich allein von allen	Sadness	Sadness
Vergessen sein, ich, dein getreuster Sohn?«	Sadness	Sadness
So ließ er laut der Klage Ruf erschallen	Sadness	Sadness
Und warf sich hin vor Jovis Thron.	Sadness	Sadness

»Wenn du im Land der Träume dich verweilet«,	Beauty / Joy	Awe / Sublime
Versetzt der Gott, »so hadre nicht mit mir.	Beauty / Joy	Awe / Sublime
Wo warst du denn, als man die Welt geteilet?«	Beauty / Joy --- Awe / Sublime	Awe / Sublime
»Ich war«, sprach der Poet, »bei dir.«	Awe / Sublime --- Beauty / Joy	Awe / Sublime

Mein Auge hing an deinem Angesichte,	Beauty / Joy --- Awe / Sublime	Awe / Sublime --- Beauty / Joy
An deines Himmels Harmonie mein Ohr -	Beauty / Joy --- Awe / Sublime	Awe / Sublime --- Beauty / Joy
Verzeih dem Geiste, der, von deinem Lichte	Beauty / Joy --- Awe / Sublime	Awe / Sublime --- Beauty / Joy
Berauscht, das Irdische verlor!«	Beauty / Joy --- Awe / Sublime	Awe / Sublime --- Beauty / Joy

»Was tun?« spricht Zeus, »die Welt ist weggegeben,	Beauty / Joy	Beauty / Joy --- Awe / Sublime
Der Herbst, die Jagd, der Markt ist nicht mehr mein.	Beauty / Joy	Beauty / Joy --- Awe / Sublime
Willst du in meinem Himmel mit mir leben -	Beauty / Joy --- Awe / Sublime	Beauty / Joy --- Awe / Sublime
So oft du kommst, er soll dir offen sein.«	Beauty / Joy --- Awe / Sublime	Beauty / Joy --- Awe / Sublime


Kassandra		

Freude war in Trojas Hallen,	Beauty / Joy	Beauty / Joy
Eh die hohe Feste fiel;	Beauty / Joy	Beauty / Joy
Jubelhymnen hört man schallen	Beauty / Joy	Beauty / Joy
In der Saiten goldnes Spiel;	Beauty / Joy	Beauty / Joy
Alle Hände ruhen müde	Beauty / Joy	Beauty / Joy
Von dem thränenvollen Streit,	Beauty / Joy	Beauty / Joy
Weil der herrliche Pelide	Beauty / Joy	Beauty / Joy
Priams schöne Tochter freit.	Beauty / Joy	Beauty / Joy

Und geschmückt mit Lorberreisern,	Beauty / Joy	Suspense
Festlich wallet Schaar auf Schaar	Beauty / Joy	Suspense
Nach der Götter heil'gen Häusern,	Beauty / Joy	Suspense
Zu des Thymbriers Altar.	Beauty / Joy	Suspense
Dumpf erbrausend durch die Gassen	Beauty / Joy	Sadness
Wälzt sich die bacchant'sche Lust,	Beauty / Joy	Sadness
Und in ihrem Schmerz verlassen	Sadness	Sadness
War nur eine traur'ge Brust.	Sadness	Sadness

Freudlos in der Freude Fülle,	Sadness	Sadness
Ungesellig und allein,	Sadness	Sadness
Wandelte Kassandra stille	Sadness	Sadness
In Apollos Lorbeerhain.	Sadness	Sadness
In des Waldes tiefste Gründe	Sadness --- Suspense	Suspense
Flüchtete die Seherin,	Sadness --- Suspense	Suspense
Und sie warf die Priesterbinde	Sadness --- Suspense	Suspense
Zu der Erde zürnend hin:	Sadness --- Suspense	Suspense

Alles ist der Freude offen,	Sadness	Sadness
Alle Herzen sind beglückt,	Sadness	Sadness
Und die alten Eltern hoffen,	Sadness	Sadness
Und die Schwester steht geschmückt.	Sadness	Sadness
Ich allein muß einsam trauern,	Sadness	Sadness
Denn mich flieht der süße Wahn,	Sadness	Sadness
Und geflügelt diesen Mauern	Sadness --- Suspense	Sadness
Seh' ich das Verderben an.	Sadness --- Suspense	Sadness

Eine Fackel seh' ich glühen,	Suspense --- Uneasiness	Uneasiness
Aber nicht in Hymens Hand;	Suspense --- Uneasiness	Uneasiness
Nach den Wolken seh' ich ziehen,	Suspense --- Uneasiness	Uneasiness
Aber nicht wie Opferbrand.	Suspense --- Uneasiness	Uneasiness
Feste seh' ich froh bereiten,	Suspense --- Uneasiness	Uneasiness
Doch im ahnungsvollen Geist	Suspense --- Uneasiness	Uneasiness
Hör' ich schon des Gottes Schreiten,	Suspense --- Uneasiness	Uneasiness
Der sie jammervoll zerreißt.	Suspense --- Uneasiness	Uneasiness

Und sie schelten meine Klagen,	Sadness	Sadness
Und sie höhnen meinen Schmerz.	Sadness	Sadness
Einsam in die Wüste tragen	Sadness	Sadness
Muß ich mein gequältes Herz,	Sadness	Sadness
Von den Glücklichen gemieden	Sadness	Sadness
Und den Fröhlichen ein Spott!	Sadness	Sadness
Schweres hast du mir beschieden,	Sadness	Sadness
Pythischer, du arger Gott!	Sadness	Sadness

Dein Orakel zu verkünden,	Sadness	Sadness
Warum warfest du mich hin	Sadness	Sadness
In die Stadt der ewig Blinden	Sadness	Sadness
Mit dem aufgeschloßnen Sinn?	Sadness	Sadness
Warum gabst du mir zu sehen,	Sadness	Sadness
Was ich doch nicht wenden kann?	Sadness	Sadness
Das Verhängte muß geschehen,	Sadness	Sadness
Das Gefürchtete muß nahn.	Sadness	Sadness

Frommt's, den Schleier aufzuheben,	Sadness	Awe / Sublime --- Sadness
Wo das nahe Schreckniß droht?	Sadness	Awe / Sublime --- Sadness
Nur der Irrthum ist das Leben,	Sadness --- Awe / Sublime	Awe / Sublime --- Sadness
Und das Wissen ist der Tod.	Sadness --- Awe / Sublime	Awe / Sublime --- Sadness
Nimm, o nimm die traur'ge Klarheit,	Sadness	Vitality
Mir vom Aug den blut'gen Schein!	Sadness	Vitality
Schrecklich ist es, deiner Wahrheit	Sadness	Vitality
Sterbliches Gefäß zu sein.	Sadness	Vitality

Meine Blindheit gib mir wieder	Sadness	Vitality
Und den fröhlich dunklen Sinn!	Sadness	Vitality
Nimmer sang ich freud'ge Lieder,	Sadness	Vitality
Seit ich deine Stimme bin.	Sadness	Vitality
Zukunft hast du mir gegeben,	Sadness	Vitality
Doch du nahmst den Augenblick,	Sadness	Vitality
Nahmst der Stunde fröhlich Leben -	Sadness	Vitality
Nimm dein falsch Geschenk zurück!	Sadness	Vitality

Nimmer mit dem Schmuck der Bräute,	Sadness	Sadness
Kränzt' ich mir das duft'ge Haar,	Sadness	Sadness
Seit ich deinem Dienst mich weihte	Sadness	Sadness
An dem traurigen Altar.	Sadness	Sadness
Meine Jugend war nur Weinen,	Sadness	Sadness
Und ich kannte nur den Schmerz,	Sadness	Sadness
Jede herbe Noth der Meinen	Sadness	Sadness
Schlug an mein empfindend Herz.	Sadness	Sadness

Fröhlich seh' ich die Gespielen,	Sadness	Sadness
Alles um mich lebt und liebt	Sadness	Sadness
In der Jugend Lustgefühlen,	Sadness	Sadness
Mir nur ist das Herz getrübt.	Sadness	Sadness
Mir erscheint der Lenz vergebens,	Sadness	Sadness
Der die Erde festlich schmückt;	Sadness	Sadness
Wer erfreute sich des Lebens,	Sadness	Sadness --- Awe / Sublime
Der in seine Tiefen blickt!	Sadness	Sadness --- Awe / Sublime

Selig preis' ich Polyxenen	Vitality	Vitality
In des Herzens trunknem Wahn,	Vitality	Vitality
Denn den Besten der Hellenen	Vitality	Vitality
Hofft sie bräutlich zu umfahn.	Vitality	Vitality
Stolz ist ihre Brust gehoben,	Vitality	Vitality
Ihre Wonne faßt sie kaum,	Vitality	Vitality
Nicht euch, Himmlische dort oben,	Vitality	Vitality
Neidet sie in ihrem Traum.	Vitality	Vitality

Und auch ich hab' ihn gesehen,	Beauty / Joy	Suspense
Den das Herz verlangend wählt!	Beauty / Joy	Suspense
Seine schönen Blicke flehen,	Beauty / Joy	Beauty / Joy
Von der Liebe Gluth beseelt.	Beauty / Joy	Beauty / Joy
Gerne möcht' ich mit dem Gatten	Sadness	Sadness
In die heim'sche Wohnung ziehn;	Sadness	Sadness
Doch es tritt ein styg'scher Schatten	Sadness	Sadness
Nächtlich zwischen mich und ihn.	Sadness	Sadness

Ihre bleichen Larven alle	Sadness	Sadness
Sendet mir Proserpina;	Sadness	Sadness
Wo ich wandre, wo ich walle,	Sadness	Sadness
Stehen mir die Geister da.	Sadness	Sadness
In der Jugend frohe Spiele	Sadness	Sadness
Drängen sie sich grausend ein,	Sadness	Sadness
Ein entsetzliches Gewühle!	Sadness	Sadness
Nimmer kann ich fröhlich sein.	Sadness	Sadness

Und den Mordstahl seh' ich blinken	Uneasiness	Uneasiness
Und das Mörderauge glühn;	Uneasiness	Uneasiness
Nicht zur Rechten, nicht zur Linken	Uneasiness	Uneasiness
Kann ich vor dem Schreckniß fliehn;	Uneasiness	Uneasiness
Nicht die Blicke darf ich wenden,	Uneasiness	Uneasiness
Wissend, schauend, unverwandt	Uneasiness	Uneasiness
Muß ich mein Geschick vollenden	Uneasiness	Uneasiness
Fallend in dem fremden Land -	Uneasiness	Uneasiness

Und noch hallen ihre Worte -	Uneasiness	Uneasiness
Horch! da dringt verworrner Ton	Uneasiness	Uneasiness
Fernher aus des Tempels Pforte,	Uneasiness	Uneasiness
Todt lag Thetis' großer Sohn!	Uneasiness	Uneasiness
Eris schüttelt ihre Schlangen,	Uneasiness	Uneasiness
Alle Götter fliehn davon,	Uneasiness	Uneasiness
Und des Donners Wolken hangen	Uneasiness	Uneasiness
Schwer herab auf Ilion.	Uneasiness	Uneasiness


Das Mädchen		

Stand ein Mädchen an dem Fenster,	Beauty / Joy	Beauty / Joy
Da es draußen Morgen war,	Beauty / Joy	Beauty / Joy
Kämmte sich die langen Haare,	Beauty / Joy	Beauty / Joy
Wusch sich ihre Äuglein klar.	Beauty / Joy	Beauty / Joy

Sangen Vöglein aller Arten,	Beauty / Joy	Beauty / Joy
Sonnenschein spielt' vor dem Haus,	Beauty / Joy	Beauty / Joy
Draußen überm schönen Garten	Beauty / Joy	Beauty / Joy
Flogen Wolken weit hinaus.	Beauty / Joy	Beauty / Joy

Und sie dehnt' sich in den Morgen,	Beauty / Joy	Beauty / Joy
Als ob sie noch schläfrig sei,	Beauty / Joy	Beauty / Joy
Ach, sie war so voller Sorgen,	Beauty / Joy	Beauty / Joy
Flocht ihr Haar und sang dabei:	Beauty / Joy	Beauty / Joy

?Wie ein Vöglein hell und reine,	Beauty / Joy	Beauty / Joy --- Vitality
Ziehet draußen muntre Lieb,	Beauty / Joy	Beauty / Joy --- Vitality
Lockt hinaus zum Sonnenscheine,	Beauty / Joy	Beauty / Joy --- Vitality
Ach, wer da zu Hause blieb?!?	Beauty / Joy	Beauty / Joy --- Vitality


Nachts		

Ich wandre durch die stille Nacht,	Beauty / Joy	Beauty / Joy
Da schleicht der Mond so heimlich sacht	Beauty / Joy	Beauty / Joy
Oft aus der dunklen Wolkenhülle,	Beauty / Joy	Beauty / Joy
Und hin und her im Tal	Beauty / Joy	Beauty / Joy
Erwacht die Nachtigall,	Beauty / Joy	Beauty / Joy
Dann wieder alles grau und stille.	Beauty / Joy	Beauty / Joy

O wunderbarer Nachtgesang:	Beauty / Joy	Beauty / Joy
Von fern im Land der Ströme Gang,	Beauty / Joy	Beauty / Joy
Leis Schauern in den dunklen Bäumen -	Beauty / Joy	Beauty / Joy
Wirrst die Gedanken mir,	Beauty / Joy	Beauty / Joy
Mein irres Singen hier	Beauty / Joy	Beauty / Joy
Ist wie ein Rufen nur aus Träumen.	Beauty / Joy	Beauty / Joy


Mondnacht		

Es war, als hätt' der Himmel	Beauty / Joy	Beauty / Joy
Die Erde still geküßt,	Beauty / Joy	Beauty / Joy
Daß sie im Blütenschimmer	Beauty / Joy	Beauty / Joy
Von ihm nun träumen müßt'.	Beauty / Joy	Beauty / Joy

Die Luft ging durch die Felder,	Beauty / Joy	Beauty / Joy
Die Ähren wogten sacht,	Beauty / Joy	Beauty / Joy
Es rauschten leis die Wälder,	Beauty / Joy	Beauty / Joy
So sternklar war die Nacht.	Beauty / Joy	Beauty / Joy

Und meine Seele spannte	Beauty / Joy --- Awe / Sublime	Beauty / Joy --- Awe / Sublime
Weit ihre Flügel aus,	Beauty / Joy --- Awe / Sublime	Beauty / Joy --- Awe / Sublime
Flog durch die stillen Lande,	Beauty / Joy --- Awe / Sublime	Beauty / Joy --- Awe / Sublime
Als flöge sie nach Haus.	Beauty / Joy --- Awe / Sublime	Beauty / Joy --- Awe / Sublime


Menschliches Elende		

Was sind wir Menschen doch! Ein Wohnhaus grimmer Schmerzen.	Sadness	Sadness --- Awe / Sublime
Ein Ball des falschen Glücks, ein Irrlicht dieser Zeit,	Sadness	Sadness --- Awe / Sublime
Ein Schauplatz herber Angst, besetzt mit scharfem Leid.	Sadness	Sadness --- Awe / Sublime
Ein bald verschmelzter Schnee und abgebrannte Kerzen.	Sadness	Sadness --- Awe / Sublime

Dies Leben fleucht davon wie ein Geschwätz und Scherzen.	Sadness	Sadness --- Awe / Sublime
Die vor uns abgelegt des schwachen Leibes Kleid	Sadness	Sadness --- Awe / Sublime
Und in das Totenbuch der großen Sterblichkeit	Sadness	Sadness --- Awe / Sublime
Längst eingeschrieben sind, sind uns aus Sinn und Herzen.	Sadness	Sadness --- Awe / Sublime

Gleich wie ein eitel Traum leicht aus der Acht hinfällt	Sadness	Sadness --- Awe / Sublime
Und wie ein Strom verscheußt, den keine Macht aufhält,	Sadness	Sadness --- Awe / Sublime
So muß auch unser Nam, Lob, Ehr und Ruhm verschwinden.	Sadness	Sadness --- Awe / Sublime

Was itzund Atem holt, muß mit der Luft entfliehn;	Sadness	Sadness --- Awe / Sublime
Was nach uns kommen wird, wird uns ins Grab nachziehn.	Sadness	Sadness --- Awe / Sublime
Was sag ich? wir vergehn, wie Rauch von starken Winden.	Sadness	Sadness --- Awe / Sublime


Die schlesischen Weber / Weberlied		

Im düstern Auge keine Träne	Annoyance	Uneasiness
Sie sitzen am Webstuhl und fletschen die Zähne:	Annoyance	Uneasiness
Deutschland, wir weben dein Leichentuch,	Annoyance --- Uneasiness	Uneasiness
Wir weben hinein den dreifachen Fluch -	Annoyance --- Uneasiness	Uneasiness
Wir weben, wir weben!	Annoyance	Uneasiness

Ein Fluch dem Gotte, zu dem wir gebeten	Annoyance	Annoyance
In Winterskälte und Hungersnöten;	Annoyance	Annoyance
Wir haben vergebens gehofft und geharrt,	Annoyance	Annoyance
Er hat uns geäfft und gefoppt und genarrt -	Annoyance	Annoyance
Wir weben, wir weben!	Annoyance	Annoyance

Ein Fluch dem König, dem König der Reichen,	Annoyance	Annoyance
Den unser Elend nicht konnte erweichen	Annoyance	Annoyance
Der den letzten Groschen von uns erpreßt	Annoyance	Annoyance
Und uns wie Hunde erschiessen läßt -	Annoyance	Annoyance
Wir weben, wir weben!	Annoyance	Annoyance

Ein Fluch dem falschen Vaterlande,	Annoyance	Annoyance --- Uneasiness
Wir nur gedeihen Schmach und Schande,	Annoyance	Annoyance --- Uneasiness
Wo jede Blume früh geknickt,	Annoyance	Annoyance --- Uneasiness
Wo Fäulnis und Moder den Wurm erquickt -	Annoyance	Annoyance --- Uneasiness
Wir weben, wir weben!	Annoyance	Annoyance --- Uneasiness

Das Schiffchen fliegt, der Webstuhl kracht,	Annoyance --- Vitality	Vitality --- Uneasiness
Wir weben emsig Tag und Nacht -	Annoyance --- Vitality	Vitality --- Uneasiness
Altdeutschland, wir weben dein Leichentuch,	Annoyance --- Vitality	Vitality --- Uneasiness
Wir weben hinein den dreifachen Fluch,	Annoyance --- Vitality	Vitality --- Uneasiness
Wir weben, wir weben!	Annoyance --- Vitality	Vitality --- Uneasiness


In einer großen Stadt		

Es treibt vorüber mir im Meer der Stadt	Sadness	Sadness
Bald der, bald jener, einer nach dem andern.	Sadness	Sadness
Ein Blick ins Auge, und vorüber schon.	Sadness	Sadness
Der Orgeldreher dreht sein Lied.	Sadness	Sadness

Es tropft vorüber mir ins Meer des Nichts	Sadness	Sadness
Bald der, bald jener, einer nach dem andern.	Sadness	Sadness
Ein Blick auf seinen Sarg, vorüber schon.	Sadness	Sadness
Der Orgeldreher dreht sein Lied.	Sadness	Sadness

Es schwimmt ein Leichenzug im Meer der Stadt,	Sadness	Sadness
Querweg die Menschen, einer nach dem andern.	Sadness	Sadness
Ein Blick auf meinen Sarg, vorüber schon.	Sadness	Sadness
Der Orgeldreher dreht sein Lied.	Sadness	Sadness


Liebeslied		

Wie soll ich meine Seele halten, daß	Sadness --- Beauty / Joy	Sadness
sie nicht an deine rührt? Wie soll ich sie	Sadness --- Beauty / Joy	Sadness
hinheben über dich zu andern Dingen?	Sadness --- Beauty / Joy	Sadness
Ach gerne möcht ich sie bei irgendwas	Sadness --- Beauty / Joy	Sadness
Verlorenem im Dunkel unterbringen	Sadness --- Beauty / Joy	Sadness
an einer fremden stillen Stelle, die	Sadness --- Beauty / Joy	Sadness
nicht weiterschwingt, wenn deine Tiefen schwingen.	Sadness --- Beauty / Joy	Sadness
Doch alles, was uns anrührt, dich und mich,	Awe / Sublime --- Beauty / Joy	Beauty / Joy
nimmt uns zusammen wie ein Bogenstrich,	Awe / Sublime --- Beauty / Joy	Beauty / Joy
der aus zwei Saiten eine Stimme zieht.	Awe / Sublime --- Beauty / Joy	Beauty / Joy
Auf welches Instrument sind wir gespannt?	Awe / Sublime --- Beauty / Joy	Beauty / Joy
Und welcher Spieler hat uns in der Hand?	Awe / Sublime --- Beauty / Joy	Beauty / Joy
O süßes Lied.	Awe / Sublime --- Beauty / Joy	Beauty / Joy


Mensch im Eisen		

Mein Tagwerk ist: im engen Kesselrohr	Uneasiness --- Annoyance	Uneasiness
bei kleinem Glühlicht kniend krumm zu sitzen ?	Uneasiness --- Annoyance	Uneasiness
an Nieten hämmernd in der Hitze schwitzen.	Uneasiness --- Annoyance	Uneasiness
Verrußt sind Aug` und Haar und Ohr ?	Uneasiness --- Annoyance	Uneasiness

Als wär ich nur ein kleiner Schlagmotor,	Annoyance	Annoyance
So lass` ich meine Arme federnd flitzen ?	Annoyance	Annoyance
Die glühnde Luft sticht wie mit giftigen Spitzen;	Annoyance	Uneasiness
Immer von neuem bricht der Schweiß hervor...	Annoyance	Uneasiness

O Mensch! Wo bist du? Wie ein Käfertier	Annoyance	Annoyance
Im Bernstein eingeschlossen hockst du rings im Eisen,	Annoyance	Annoyance
Eisen umpanzert dich in schließendem Gewirr.	Annoyance	Annoyance

Im Auge rast die Seele, arm und irr.	Sadness	Sadness
Heimweh heult wahnsinnswild, Heimweh weint süße Weisen	Sadness	Sadness
Nach Erde, Mensch und Licht. So schrei doch, Mensch im Eisen!	Sadness	Sadness


Berlin I		

Beteerte Fässer rollten von den Schwellen	Uneasiness	Uneasiness
Der dunklen Speicher auf die hohen Kähne.	Uneasiness	Uneasiness
Die Schlepper zogen an. Des Rauches Mähne	Uneasiness	Uneasiness
Hing rußig nieder auf die öligen Wellen.	Uneasiness	Uneasiness

Zwei Dampfer kamen mit Musikkapellen.	Vitality	Vitality --- Uneasiness
Den Schornstein kappten sie am Brückenbogen.	Vitality	Vitality --- Uneasiness
Rauch, Ruß, Gestank lag auf den schmutzigen Wogen	Vitality --- Uneasiness	Vitality --- Uneasiness
Der Gerbereien mit den braunen Fellen.	Vitality --- Uneasiness	Vitality --- Uneasiness

In allen Brücken, drunter uns die Zille	Vitality	Vitality
Hindurchgebracht, ertönten die Signale	Vitality	Vitality
Gleichwie in Trommeln wachsend in der Stille.	Vitality	Vitality

Wir ließen los und trieben im Kanale	Beauty / Joy	Beauty / Joy
An Gärten langsam hin. In dem Idylle	Beauty / Joy	Beauty / Joy
Sahn wir der Riesenschlote Nachtfanale.	Beauty / Joy	Beauty / Joy


Blauer Abend in Berlin		

Der Himmel fließt in steinernen Kanälen;	Beauty / Joy	Beauty / Joy
Denn zu Kanälen steilrecht ausgehauen	Beauty / Joy	Beauty / Joy
Sind alle Straßen, voll vom Himmelblauen;	Beauty / Joy	Beauty / Joy
Und Kuppeln gleichen Bojen, Schlote Pfählen	Beauty / Joy	Beauty / Joy

Im Wasser. Schwarze Essendämpfe schwelen	Uneasiness	Uneasiness
Und sind wie Wasserpflanzen anzuschauen.	Uneasiness	Uneasiness
Die Leben, die sich ganz am Grunde stauen,	Beauty / Joy	Beauty / Joy
Beginnen sacht vom Himmel zu erzählen,	Beauty / Joy	Beauty / Joy

Gemengt, entwirrt nach blauen Melodien.	Beauty / Joy	Beauty / Joy
Wie eines Wassers Bodensatz und Tand	Beauty / Joy	Beauty / Joy
regt sie des Wassers Wille und Verstand	Beauty / Joy	Beauty / Joy

Im Dünen, Kommen, Gehen, Gleiten, Ziehen.	Beauty / Joy	Beauty / Joy
Die Menschen sind wie grober bunter Sand	Beauty / Joy	Beauty / Joy --- Awe / Sublime
Im linden Spiel der großen Wellenhand.	Beauty / Joy	Beauty / Joy --- Awe / Sublime


Die Dämmerung		

Im Hof, verhext von milchigem Dämmerschein,	Sadness --- Uneasiness	Uneasiness
Durch Herbstgebräuntes weiche Kranke gleiten.	Sadness --- Uneasiness	Uneasiness
Ihr wächsern-runder Blick sinnt goldner Zeiten,	Sadness	Beauty / Joy
Erfüllt von Träumerei und Ruh und Wein.	Sadness	Beauty / Joy

Ihr Siechtum schließt geisterhaft sich ein.	Sadness	Uneasiness
Die Sterne weiße Traurigkeit verbreiten.	Sadness	Sadness
Im Grau, erfüllt von Täuschung und Geläuten,	Sadness --- Uneasiness	Sadness
Sieh, wie die Schrecklichen sich wirr zerstreun.	Sadness --- Uneasiness	Sadness

Formlose Spottgestalten huschen, kauern	Uneasiness	Uneasiness
Und flattern sie auf schwarz-gekreuzten Pfaden.	Uneasiness	Uneasiness
O! trauervolle Schatten an den Mauern.	Uneasiness	Uneasiness

Die andern fliehn durch dunkelnde Arkaden;	Uneasiness	Uneasiness
Und nächtens stürzen sie aus roten Schauern	Uneasiness	Uneasiness
Des Sternenwinds, gleich rasenden Mänaden.	Uneasiness	Uneasiness


Halber Schlaf		

Die Finsternis raschelt wie ein Gewand,	Humor --- Beauty / Joy	Humor --- Beauty / Joy
Die Bäume torkeln am Himmelsrand.	Humor --- Beauty / Joy	Humor --- Beauty / Joy

Rette dich in das Herz der Nacht,	Uneasiness --- Vitality	Vitality
Grabe dich schnell in das Dunkele ein,	Uneasiness --- Vitality	Vitality
Wie in Waben. Mache dich klein,	Uneasiness --- Vitality	Vitality
Steige aus deinem Bette.	Uneasiness --- Vitality	Vitality

Etwas will über die Brücken,	Uneasiness	Uneasiness
Er scharret mit Hufen krumm,	Uneasiness	Uneasiness
Die Sterne erschraken so weiß.	Uneasiness	Uneasiness

Und der Mond wie ein Greis	Humor	Humor
Watschelt oben herum	Humor	Humor
Mit dem höckrigen Rücken.	Humor	Humor


Die Stadt		

Ein weißer Vogel ist der große Himmel.	Beauty / Joy	Suspense
Hart unter ihn geduckt stiert eine Stadt.	Uneasiness	Uneasiness --- Suspense
Die Häuser sind halbtote alte Leute.	Uneasiness	Uneasiness --- Suspense

Griesgrämig glotzt ein dünner Droschkenschimmel.	Uneasiness	Suspense
Und Winde, magre Hunde, rennen matt.	Uneasiness	Suspense --- Uneasiness
An scharfen Ecken quietschen ihre Häute.	Uneasiness	Uneasiness

In einer Straße stöhnt ein Irrer: Du, ach, du ?	Uneasiness --- Sadness	Sadness
Wenn ich dich endlich, o Geliebte, fände ...	Uneasiness --- Sadness	Sadness
Ein Haufen um ihn staunt und grinst voll Spott.	Uneasiness --- Sadness	Sadness --- Annoyance

Drei kleine Menschen spielen Blindekuh ?	Beauty / Joy --- Sadness	Sadness
Auf alles legt die grauen Puderhände	Beauty / Joy --- Sadness	Sadness
Der Nachmittag, ein sanft verweinter Gott.	Beauty / Joy --- Sadness	Sadness


Im Dämmer		

Im schwarzen Spiegel der Kanäle zuckt	Beauty / Joy	Beauty / Joy
die bunte Lichterkette der Fabriken.	Beauty / Joy	Beauty / Joy
Die niedren Straßen sind bis zum Ersticken	Uneasiness	Uneasiness
mit Rauch geschwängert, den ein Windstoß niederduckt.	Uneasiness	Uneasiness

Ein Menschentrupp, vom Frohndienst abgehärmt,	Annoyance --- Sadness	Annoyance
schwankt schweigsam in die ärmlichen Kabinen;	Annoyance --- Sadness	Annoyance
indes sich in den qualmigen Kantinen	Annoyance --- Sadness	Annoyance
die tolle Jugend fuselselig lärmt.	Annoyance --- Sadness	Annoyance

Nocheinmal wirft der Drahtseilzug mit Kreischen	Uneasiness	Uneasiness
Den Schlackenschutt hinunter in die flachen	Uneasiness	Uneasiness
Gelände, drin der Schwefelsumpf erlischt.	Uneasiness	Uneasiness

Fern aber gähnen schon, vom Dampf umzischt,	Uneasiness	Uneasiness
des Walzwerks zwiegespaltne Feuerrachen ?	Uneasiness	Uneasiness
und harrn des Winks den Himmel zu zerfleischen.	Uneasiness	Uneasiness


Sturmangriff		

Aus allen Winkeln gellen Fürchte Wollen	Uneasiness	Uneasiness
Kreisch	Uneasiness	Uneasiness
Peitscht	Uneasiness	Uneasiness
Das Leben	Uneasiness	Uneasiness
Vor	Uneasiness	Uneasiness
Sich	Uneasiness	Uneasiness
Her	Uneasiness	Uneasiness
Den keuchen Tod	Uneasiness	Uneasiness
Die Himmel fetzen.	Uneasiness	Uneasiness
Blinde schlächtert wildum das Entsetzen.	Uneasiness	Uneasiness


Städter		

Dicht wie die Löcher eines Siebes stehn	Uneasiness	Uneasiness
Fenster beieinander, drängend fassen	Uneasiness	Uneasiness
Häuser sich so dicht an, daß die Straßen	Uneasiness	Uneasiness
Grau geschwollen wie Gewürgte stehn.	Uneasiness	Uneasiness

Ineinander dicht hineingehakt	Sadness	Beauty / Joy
Sitzen in den Trams die zwei Fassaden	Sadness	Beauty / Joy
Leute, ihre nahen Blicke baden	Sadness	Beauty / Joy
Ineinander, ohne Scheu befragt.	Sadness	Beauty / Joy

Unsre Wände sind so dünn wie Haut,	Sadness	Sadness
Daß ein jeder teilnimmt, wenn ich weine.	Sadness	Sadness
Unser Flüstern, Denken ... wird Gegröle ...	Sadness	Sadness

- Und wie still in dick verschlossner Höhle	Sadness	Awe / Sublime --- Sadness
Ganz unangerührt und ungeschaut	Sadness	Awe / Sublime --- Sadness
Steht ein jeder fern und fühlt: alleine	Sadness	Awe / Sublime --- Sadness


Das Rosenband		

Im Frühlingsschatten fand ich Sie;	Suspense --- Beauty / Joy	Beauty / Joy
Da band ich Sie mit Rosenbändern:	Beauty / Joy	Beauty / Joy
Sie fühlt' es nicht, und schlummerte.	Beauty / Joy	Beauty / Joy

Ich sah Sie an; mein Leben hing	Beauty / Joy	Beauty / Joy
Mit diesem Blick' an Ihrem Leben:	Beauty / Joy	Beauty / Joy
Ich fühlt' es wohl, und wußt' es nicht.	Beauty / Joy	Beauty / Joy

Doch lispelt' ich Ihr sprachlos zu,	Beauty / Joy	Beauty / Joy
Und rauschte mit den Rosenbändern:	Beauty / Joy	Beauty / Joy
Da wachte Sie vom Schlummer auf.	Suspense --- Beauty / Joy	Beauty / Joy

Sie sah mich an; Ihr Leben hing	Beauty / Joy --- Awe / Sublime	Beauty / Joy
Mit diesem Blick' an meinem Leben,	Beauty / Joy --- Awe / Sublime	Beauty / Joy
Und um uns ward's Elysium.	Beauty / Joy --- Awe / Sublime	Beauty / Joy


Maifest / Mailied		

Wie herrlich leuchtet	Vitality --- Beauty / Joy	Beauty / Joy
Mir die Natur!	Vitality --- Beauty / Joy	Beauty / Joy
Wie glänzt die Sonne!	Vitality --- Beauty / Joy	Beauty / Joy
Wie lacht die Flur!	Vitality --- Beauty / Joy	Beauty / Joy

Es dringen Blüten	Vitality	Vitality
Aus jedem Zweig	Vitality	Vitality
Und tausend Stimmen	Vitality	Vitality
Aus dem Gesträuch	Vitality	Vitality

Und Freud und Wonne	Vitality	Vitality
Aus jeder Brust.	Vitality	Vitality
O Erd', o Sonne,	Vitality	Vitality
O Glück, o Lust,	Vitality	Vitality

O Lieb', o Liebe,	Beauty / Joy	Beauty / Joy
So golden schön	Beauty / Joy	Beauty / Joy
Wie Morgenwolken	Beauty / Joy	Beauty / Joy
Auf jenen Höhn,	Beauty / Joy	Beauty / Joy

Du segnest herrlich	Beauty / Joy	Beauty / Joy
Das frische Feld -	Beauty / Joy	Beauty / Joy
Im Blütendampfe	Beauty / Joy	Beauty / Joy
Die volle Welt!	Beauty / Joy	Beauty / Joy

O Mädchen, Mädchen,	Vitality	Beauty / Joy
Wie lieb' ich dich!	Vitality	Beauty / Joy
Wie blinkt dein Auge,	Vitality	Beauty / Joy
Wie liebst du mich!	Vitality	Beauty / Joy

So liebt die Lerche	Beauty / Joy	Beauty / Joy
Gesang und Luft,	Beauty / Joy	Beauty / Joy
Und Morgenblumen	Beauty / Joy	Beauty / Joy
Den Himmelsduft,	Beauty / Joy	Beauty / Joy

Wie ich dich liebe	Beauty / Joy	Beauty / Joy
Mit warmem Blut,	Beauty / Joy	Beauty / Joy
Die du mir Jugend	Beauty / Joy	Beauty / Joy
Und Freud und Mut	Beauty / Joy	Beauty / Joy

Zu neuen Liedern	Beauty / Joy	Beauty / Joy
Und Tänzen gibst.	Beauty / Joy	Beauty / Joy
Sei ewig glücklich,	Beauty / Joy --- Awe / Sublime	Beauty / Joy
Wie du mich liebst.	Beauty / Joy --- Awe / Sublime	Beauty / Joy


Rastlose Liebe		

Dem Schnee, dem Regen,	Vitality	Vitality
dem Wind entgegen,	Vitality	Vitality
im Dampf der Klüfte,	Vitality	Vitality
durch Nebeldüfte,	Vitality	Vitality
immer zu! Immer zu!	Vitality	Vitality
Ohne Rast und Ruh!	Vitality	Vitality

Lieber durch Leiden	Vitality --- Sadness	Vitality
möcht' ich mich schlagen,	Vitality --- Sadness	Vitality
also so viel Freuden	Vitality --- Sadness	Vitality
des Lebens ertragen.	Vitality --- Sadness	Vitality
Alle das Neigen	Vitality --- Sadness	Sadness
von Herzen zu Herzen,	Vitality --- Sadness	Sadness
ach, wie so eigen	Vitality --- Sadness	Sadness
schaffet das Schmerzen!	Vitality --- Sadness	Sadness

Wie - soll ich fliehen?	Vitality	Vitality
Wälderwärts ziehen?	Vitality	Vitality
Alles vergebens!	Vitality	Vitality
Krone des Lebens,	Vitality --- Awe / Sublime	Vitality
Glück ohne Ruh,	Vitality --- Awe / Sublime	Vitality
Liebe, bist du!	Vitality --- Awe / Sublime	Vitality


Wanderers Nachtlied		

Der du von dem Himmel bist,	Awe / Sublime --- Beauty / Joy	Beauty / Joy
Alle Freud (Alles Leid) und Schmerzen stillest,	Awe / Sublime --- Beauty / Joy	Beauty / Joy
Den, der doppelt elend ist,	Awe / Sublime --- Beauty / Joy	Beauty / Joy
Doppelt mit Erquickung füllest;	Awe / Sublime --- Beauty / Joy	Beauty / Joy
Ach,ich bin des Treibens müde!	Sadness	Vitality --- Sadness
Was soll all die Qual (der Schmerz) und Lust?	Sadness	Vitality --- Sadness
Süßer Friede,	Sadness	Vitality --- Sadness
Komm,ach komm in meine Brust!	Sadness	Vitality --- Sadness


Nähe des Geliebten		

Ich denke dein, wenn mir der Sonne Schimmer	Beauty / Joy	Beauty / Joy
vom Meere strahlt;	Beauty / Joy	Beauty / Joy
Ich denke dein, wenn sich des Mondes Flimmer	Beauty / Joy	Beauty / Joy
In Quellen malt.	Beauty / Joy	Beauty / Joy

Ich sehe dich, wenn auf dem fernen Wege	Beauty / Joy	Beauty / Joy
Der Staub sich hebt;	Beauty / Joy	Beauty / Joy
In tiefer Nacht, wenn auf dem schmalen Stege	Beauty / Joy	Beauty / Joy
Der Wandrer bebt.	Beauty / Joy	Beauty / Joy

Ich höre dich, wenn dort mit dumpfem Rauschen	Beauty / Joy	Beauty / Joy
Die Welle steigt.	Beauty / Joy	Beauty / Joy
Im stillen Haine geh' ich oft zu lauschen,	Beauty / Joy	Beauty / Joy
Wenn alles schweigt.	Beauty / Joy	Beauty / Joy

Ich bin bei dir; du seist auch noch so ferne,	Beauty / Joy	Beauty / Joy
Du bist mir nah!	Beauty / Joy	Beauty / Joy
Die Sonne sinkt, bald leuchten mir die Sterne.	Beauty / Joy	Beauty / Joy
O, wärst du da!	Beauty / Joy	Beauty / Joy


Der Handschuh		

Vor seinem Löwengarten,	Suspense	Suspense
Das Kampfspiel zu erwarten,	Suspense	Suspense
Saß König Franz,	Suspense	Suspense
Und um ihn die Großen der Krone,	Suspense --- Beauty / Joy	Suspense
Und rings auf hohem Balkone	Suspense --- Beauty / Joy	Suspense
Die Damen in schönem Kranz.	Suspense --- Beauty / Joy	Suspense

Und wie er winkt mit dem Finger,	Suspense	Suspense
Auf tut sich der weite Zwinger,	Suspense	Suspense
Und hinein mit bedächtigem Schritt	Suspense	Suspense
Ein Löwe tritt,	Suspense	Suspense
Und sieht sich stumm	Suspense	Suspense
Rings um,	Suspense	Suspense
Mit langem Gähnen,	Suspense	Suspense
Und schüttelt die Mähnen,	Suspense	Suspense --- Humor
Und streckt die Glieder,	Suspense	Suspense --- Humor
Und legt sich nieder.	Suspense	Suspense --- Humor

Und der König winkt wieder,	Suspense	Suspense
Da öffnet sich behend	Suspense	Suspense
Ein zweites Tor,	Suspense	Suspense
Daraus rennt	Suspense	Suspense
Mit wildem Sprunge	Suspense	Suspense
Ein Tiger hervor,	Suspense	Suspense
Wie der den Löwen erschaut,	Suspense	Suspense
Brüllt er laut,	Suspense	Suspense
Schlägt mit dem Schweif	Suspense	Suspense
Einen furchtbaren Reif,	Suspense	Suspense
Und recket die Zunge,	Suspense	Suspense
Und im Kreise scheu	Suspense	Suspense --- Humor
Umgeht er den Leu	Suspense	Humor --- Suspense
Grimmig schnurrend;	Suspense	Humor --- Suspense
Drauf streckt er sich murrend	Suspense	Humor --- Suspense
Zur Seite nieder.	Suspense	Humor --- Suspense

Und der König winkt wieder,	Suspense	Suspense
Da speit das doppelt geöffnete Haus	Suspense	Suspense
Zwei Leoparden auf einmal aus,	Suspense	Suspense
Die stürzen mit mutiger Kampfbegier	Suspense --- Uneasiness	Suspense
Auf das Tigertier,	Suspense --- Uneasiness	Suspense
Das packt sie mit seinen grimmigen Tatzen,	Suspense --- Uneasiness	Suspense
Und der Leu mit Gebrüll	Suspense --- Uneasiness	Suspense
Richtet sich auf, da wird's still,	Suspense --- Uneasiness	Suspense
Und herum im Kreis,	Suspense --- Uneasiness	Suspense
Von Mordsucht heiß,	Suspense --- Uneasiness	Suspense
Lagern die greulichen Katzen.	Suspense --- Uneasiness	Suspense

Da fällt von des Altans Rand	Suspense	Suspense
Ein Handschuh von schöner Hand	Suspense	Suspense
Zwischen den Tiger und den Leun	Suspense	Suspense
Mitten hinein.	Suspense	Suspense

Und zu Ritter Delorges spottenderweis	Suspense --- Humor	Humor --- Suspense
Wendet sich Fräulein Kunigund:	Suspense --- Humor	Humor --- Suspense
»Herr Ritter, ist Eure Lieb so heiß,	Suspense --- Humor	Humor --- Suspense
Wie Ihr mir's schwört zu jeder Stund,	Suspense --- Humor	Humor --- Suspense
Ei, so hebt mir den Handschuh auf.«	Suspense --- Humor	Humor --- Suspense

Und der Ritter in schnellem Lauf	Suspense	Suspense
Steigt hinab in den furchtbarn Zwinger	Suspense	Suspense
Mit festem Schritte,	Suspense	Suspense
Und aus der Ungeheuer Mitte	Suspense	Suspense
Nimmt er den Handschuh mit keckem Finger.	Suspense	Suspense

Und mit Erstaunen und mit Grauen	Beauty / Joy	Beauty / Joy
Sehen's die Ritter und Edelfrauen,	Beauty / Joy	Beauty / Joy
Und gelassen bringt er den Handschuh zurück.	Beauty / Joy	Beauty / Joy
Da schallt ihm sein Lob aus jedem Munde,	Beauty / Joy	Beauty / Joy
Aber mit zärtlichem Liebesblick ?	Beauty / Joy	Beauty / Joy
Er verheißt ihm sein nahes Glück ?	Beauty / Joy	Beauty / Joy
Empfängt ihn Fräulein Kunigunde.	Beauty / Joy	Beauty / Joy
Und er wirft ihr den Handschuh ins Gesicht:	Beauty / Joy --- Humor	Humor
»Den Dank, Dame, begehr ich nicht«,	Beauty / Joy --- Humor	Humor
Und verläßt sie zur selben Stunde.	Beauty / Joy --- Humor	Humor


Wenn die Sonne weggegangen		

Wenn die Sonne weggegangen,	Suspense --- Beauty / Joy	Beauty / Joy
kommt die Dunkelheit heran,	Suspense --- Beauty / Joy	Beauty / Joy
Abendrot hat goldne Wangen,	Beauty / Joy	Beauty / Joy
und die Nacht hat Trauer an.	Beauty / Joy	Beauty / Joy

Seit die Liebe weggegangen,	Sadness	Sadness
bin ich nun ein Mohrenkind,	Sadness	Sadness
und die roten frohen Wangen	Sadness	Sadness
dunkel und verloren sind.	Sadness	Sadness

Dunkelheit muß tief verschweigen	Sadness	Sadness
alles Wehe, alle Lust;	Sadness	Sadness
aber Mond und Sterne zeigen,	Beauty / Joy --- Sadness	Sadness
was mir wohnet in der Brust.	Beauty / Joy --- Sadness	Sadness

Wenn die Lippen dir verschweigen	Beauty / Joy --- Sadness	Sadness
meines Herzens stille Glut,	Beauty / Joy --- Sadness	Sadness
müssen Blick und Tränen zeigen,	Beauty / Joy --- Sadness	Sadness
wie die Liebe nimmer ruht.	Beauty / Joy --- Sadness	Sadness


Der Kuß im Traume		

Es hat ein Kuß mir Leben eingehaucht,	Vitality	Vitality
Gestillet meines Busens tiefstes Schmachten,	Vitality	Vitality
Komm, Dunkelheit! mich traulich zu umnachten,	Vitality	Vitality
Daß neue Wonne meine Lippe saugt.	Vitality	Vitality

In Träume war solch Leben eingetaucht,	Beauty / Joy --- Sadness	Beauty / Joy
Drum leb' ich, ewig Träume zu betrachten,	Beauty / Joy --- Sadness	Beauty / Joy
Kann aller andern Freuden Glanz verachten	Beauty / Joy --- Sadness	Beauty / Joy
Weil nur die Nacht so süßen Balsam haucht.	Beauty / Joy --- Sadness	Beauty / Joy

Der Tag ist karg an liebesüßen Wonnen,	Sadness	Sadness
Es schmerzt mich seines Lichtes eitles Prangen	Sadness	Sadness
Und mich verzehren seiner Sonne Gluthen.	Sadness	Sadness
Drum birg dich Aug' dem Glanze irrd'scher Sonnen!	Sadness --- Vitality	Sadness --- Vitality
Hüll' dich in Nacht, sie stillet dein Verlangen	Sadness --- Vitality	Vitality --- Sadness
Und heilt den Schmerz, wie Lethes kühle Fluthen.	Sadness --- Vitality	Vitality --- Sadness


Nachtlied		

Vergangen ist der lichte Tag,	Beauty / Joy	Beauty / Joy
Von ferne kommt der Glocken Schlag;	Beauty / Joy	Beauty / Joy
So reist die Zeit die ganze Nacht,	Beauty / Joy	Beauty / Joy
Nimmt manchen mit, der's nicht gedacht.	Beauty / Joy	Beauty / Joy

Wo ist nun hin die bunte Lust,	Sadness	Sadness
Des Freundes Trost und treue Brust,	Sadness	Sadness
Des Weibes süßer Augenschein?	Sadness	Sadness
Will keiner mit mir munter sein?	Sadness	Sadness

Da's nun so stille auf der Welt,	Beauty / Joy	Beauty / Joy
Ziehn Wolken einsam übers Feld,	Beauty / Joy	Beauty / Joy
Und Feld und Baum besprechen sich ?	Beauty / Joy	Beauty / Joy
O Menschenkind! was schauert dich?	Beauty / Joy	Beauty / Joy

Wie weit die falsche Welt auch sei,	Beauty / Joy --- Awe / Sublime	Awe / Sublime
Bleibt mir doch Einer nur getreu,	Beauty / Joy --- Awe / Sublime	Awe / Sublime
Der mit mir weint, der mit mir wacht,	Beauty / Joy --- Awe / Sublime	Awe / Sublime
Wenn ich nur recht an ihn gedacht.	Beauty / Joy --- Awe / Sublime	Awe / Sublime

Frisch auf denn, liebe Nachtigall,	Vitality	Vitality
Du Wasserfall mit hellem Schall!	Vitality	Vitality
Gott loben wollen wir vereint,	Vitality	Vitality
Bis daß der lichte Morgen scheint!	Vitality	Vitality


Waldgespräch		

Es ist schon spät, es wird schon kalt,	Uneasiness	Uneasiness
Was reit?st du einsam durch den Wald?	Uneasiness	Uneasiness
Der Wald ist lang, du bist allein,	Uneasiness	Uneasiness
Du schöne Braut! Ich führ? dich heim!	Uneasiness	Uneasiness

?Groß ist der Männer Trug und List,	Uneasiness --- Suspense	Sadness --- Suspense
Vor Schmerz mein Herz gebrochen ist,	Uneasiness --- Suspense	Sadness --- Suspense
Wohl irrt das Waldhorn her und hin,	Uneasiness --- Suspense	Sadness --- Suspense
O flieh! Du weißt nicht, wer ich bin.?	Uneasiness --- Suspense	Sadness --- Suspense

So reich geschmückt ist Roß und Weib,	Beauty / Joy	Beauty / Joy
So wunderschön der junge Leib,	Beauty / Joy	Beauty / Joy
Jetzt kenn? ich dich ? Gott steh? mir bei!	Uneasiness	Beauty / Joy
Du bist die Hexe Lorelei.	Uneasiness	Beauty / Joy

?Du kennst mich wohl ? von hohem Stein	Uneasiness	Uneasiness
Schaut still mein Schloß tief in den Rhein.	Uneasiness	Uneasiness
Es ist schon spät, es wird schon kalt,	Uneasiness	Uneasiness
Kommst nimmermehr aus diesem Wald!?	Uneasiness	Uneasiness


Mein Herz, mein Herz ist traurig		

Mein Herz, mein Herz ist traurig,	Sadness	Sadness
Doch lustig leuchtet der Mai;	Beauty / Joy	Sadness
Ich stehe, gelehnt an der Linde,	Beauty / Joy	Sadness
Hoch auf der alten Bastei.	Beauty / Joy	Sadness

Da drunten fließt der blaue	Beauty / Joy	Beauty / Joy
Stadtgraben in stiller Ruh;	Beauty / Joy	Beauty / Joy
Ein Knabe fährt im Kahne,	Beauty / Joy	Beauty / Joy
Und angelt und pfeift dazu.	Beauty / Joy	Beauty / Joy

Jenseits erheben sich freundlich,	Beauty / Joy	Beauty / Joy
In winziger, bunter Gestalt,	Beauty / Joy	Beauty / Joy
Lusthäuser, und Gärten, und Menschen,	Beauty / Joy	Beauty / Joy
Und Ochsen, und Wiesen, und Wald.	Beauty / Joy	Beauty / Joy

Die Mägde bleichen Wäsche,	Beauty / Joy	Beauty / Joy
Und springen im Gras herum;	Beauty / Joy	Beauty / Joy
Das Mühlrad stäubt Diamanten,	Beauty / Joy	Beauty / Joy
Ich höre sein fernes Gesumm.	Beauty / Joy	Beauty / Joy

Am alten grauen Turme	Beauty / Joy	Beauty / Joy
Ein Schilderhäuschen steht;	Beauty / Joy	Beauty / Joy
Ein rotgeröckter Bursche	Beauty / Joy	Beauty / Joy
Dort auf und nieder geht.	Beauty / Joy	Beauty / Joy

Er spielt mit seiner Flinte,	Beauty / Joy	Beauty / Joy
Die funkelt im Sonnenrot,	Beauty / Joy	Beauty / Joy
Er präsentiert und schultert -	Beauty / Joy	Beauty / Joy
Ich wollt, er schösse mich tot.	Sadness	Sadness


Um Mitternacht		

Gelassen stieg die Nacht ans Land,	Beauty / Joy	Beauty / Joy
Lehnt träumend an der Berge Wand,	Beauty / Joy	Beauty / Joy
Ihr Auge sieht die goldne Waage nun	Beauty / Joy	Beauty / Joy
Der Zeit in gleichen Schalen stille ruhn;	Beauty / Joy	Beauty / Joy
Und kecker rauschen die Quellen hervor,	Beauty / Joy	Beauty / Joy
Sie singen der Mutter, der Nacht, ins Ohr	Beauty / Joy	Beauty / Joy
Vom Tage,	Beauty / Joy	Beauty / Joy
Vom heute gewesenen Tage.	Beauty / Joy	Beauty / Joy

Das uralt alte Schlummerlied,	Beauty / Joy --- Sadness	Sadness
Sie achtet's nicht, sie ist es müd;	Beauty / Joy --- Sadness	Sadness
Ihr klingt des Himmels Bläue süßer noch,	Beauty / Joy --- Sadness	Sadness
Der flüchtgen Stunden gleichgeschwungnes Joch.	Beauty / Joy --- Sadness	Sadness
Doch immer behalten die Quellen das Wort,	Beauty / Joy --- Sadness	Sadness
Es singen die Wasser im Schlafe noch fort	Beauty / Joy --- Sadness	Sadness
Vom Tage,	Beauty / Joy --- Sadness	Sadness
Vom heute gewesenen Tage.	Beauty / Joy --- Sadness	Sadness


Neue Liebe		

Herz, mein Herz, warum so fröhlich,	Vitality --- Beauty / Joy	Beauty / Joy
So voll Unruh und zerstreut,	Vitality --- Beauty / Joy	Beauty / Joy
Als käm über Berge selig	Vitality --- Beauty / Joy	Beauty / Joy
Schon die schöne Frühlingszeit?	Vitality --- Beauty / Joy	Beauty / Joy

Weil ein liebes Mädchen wieder	Beauty / Joy	Beauty / Joy
Herzlich an dein Herz sich drückt,	Beauty / Joy	Beauty / Joy
Schaust du fröhlich auf und nieder,	Beauty / Joy	Beauty / Joy
Erd und Himmel dich erquickt.	Beauty / Joy	Beauty / Joy

Und ich hab die Fenster offen,	Vitality	Vitality
Neu zieh in die Welt hinein	Vitality	Vitality
Altes Bangen, altes Hoffen!	Vitality	Vitality
Frühling, Frühling soll es sein!	Vitality	Vitality

Still kann ich hier nicht mehr bleiben,	Vitality	Vitality
Durch die Brust ein Singen irrt,	Vitality	Vitality
Doch zu licht ist's mir zum Schreiben,	Vitality	Vitality
Und ich bin so froh verwirrt.	Vitality	Vitality

Also schlendr' ich durch die Gassen,	Vitality	Vitality
Menschen gehen her und hin,	Vitality	Vitality
Weiß nicht, was ich tu und lasse,	Vitality	Vitality
Nur, daß ich so glücklich bin.	Vitality	Vitality


In seinem Garten wandelt er allein		

In seinem Garten wandelt er allein;	Sadness	Sadness
In alle Bäume gräbt er immer wieder	Sadness	Sadness
Gedankenschwer den einz'gen Namen ein,	Sadness	Sadness
Und in dem Namen klagen seine Lieder.	Sadness	Sadness

Sanft blaut der Himmel, milde Rosen webt	Sadness --- Beauty / Joy	Beauty / Joy
Die Sommerzeit durch mächt'ge Blättermassen.	Sadness --- Beauty / Joy	Beauty / Joy
Er schaut sie nicht; die Zeit, in der er lebt,	Sadness	Sadness
Ist alt, verblüht, von allen längst verlassen.	Sadness	Sadness


Zur Beruhigung		

Wir schlafen ganz, wie Brutus schlief -	Suspense	Suspense
Doch jener erwachte und bohrte tief	Suspense	Suspense
In Cäsars Brust das kalte Messer!	Suspense	Suspense
Die Römer waren Tyrannenfresser.	Suspense	Suspense

Wir sind keine Römer, wir rauchen Tabak.	Humor	Humor
Ein jedes Volk hat seinen Geschmack,	Humor	Humor
Ein jedes Volk hat seine Größe;	Humor	Humor
In Schwaben kocht man die besten Klöße.	Humor	Humor

Wir sind Germanen, gemütlich und brav,	Humor	Beauty / Joy --- Humor
Wir schlafen gesunden Pflanzenschlaf,	Humor	Beauty / Joy --- Humor
Und wenn wir erwachen, pflegt uns zu dürsten,	Humor	Beauty / Joy --- Humor
Doch nicht nach dem Blute unserer Fürsten.	Humor	Beauty / Joy --- Humor

Wir sind so treu wie Eichenholz,	Humor	Beauty / Joy
Auch Lindenholz, drauf sind wir stolz;	Humor	Beauty / Joy
Im Land der Eichen und der Linden	Humor	Beauty / Joy
Wird niemals sich ein Brutus finden.	Humor	Beauty / Joy

Und wenn auch ein Brutus unter uns wär,	Humor	Humor
Den Cäsar fänd er nimmermehr,	Humor	Humor
Vergeblich würd er den Cäsar suchen;	Humor	Humor
Wir haben gute Pfefferkuchen.	Humor	Humor

Wir haben sechsunddreißig Herrn	Humor	Humor
(Ist nicht zuviel!), und einen Stern	Humor	Humor
Trägt jeder schützend auf seinem Herzen,	Humor	Humor
Und er braucht nicht zu fürchten die Iden des Märzen.	Humor	Humor

Wir nennen sie Väter, und Vaterland	Humor	Humor
Benennen wir dasjenige Land,	Humor	Humor
das erbeigentümlich gehört den Fürsten;	Humor	Humor
Wir lieben auch Sauerkraut mit Würsten.	Humor	Humor

Wenn unser Vater spazieren geht,	Humor	Humor
Ziehn wir den Hut mit Pietät;	Humor	Humor
Deutschland, die fromme Kinderstube,	Humor	Beauty / Joy
Ist keine römische Mördergrube.	Humor	Beauty / Joy


Die Stadt		

Am grauen Strand, am grauen Meer	Beauty / Joy --- Sadness	Sadness
Und seitab liegt die Stadt;	Beauty / Joy --- Sadness	Sadness
Der Nebel drückt die Dächer schwer,	Beauty / Joy --- Sadness	Sadness
Und durch die Stille braust das Meer	Beauty / Joy --- Sadness	Sadness
Eintönig um die Stadt.	Beauty / Joy --- Sadness	Sadness

Es rauscht kein Wald, es schlägt im Mai	Sadness	Sadness
Kein Vogel ohn Unterlaß;	Sadness	Sadness
Die Wandergans mit hartem Schrei	Sadness	Sadness
Nur fliegt in Herbstesnacht vorbei,	Sadness	Sadness
Am Strande weht das Gras.	Sadness	Sadness

Doch hängt mein ganzes Herz an dir,	Beauty / Joy	Beauty / Joy
Du graue Stadt am Meer;	Beauty / Joy	Beauty / Joy
Der Jugend Zauber für und für	Beauty / Joy	Beauty / Joy
Ruht lächelnd doch auf dir, auf dir,	Beauty / Joy	Beauty / Joy
Du graue Stadt am Meer.	Beauty / Joy	Beauty / Joy


Tränen in schwerer Krankheit		

Mir ist, ich weiß nicht wie, ich seufze für und für.	Sadness	Sadness
Ich weine Tag und Nacht; ich sitz' in tausend Schmerzen;	Sadness	Sadness
Und tausend fürcht' ich noch; die Kraft in meinem Herzen	Sadness --- Uneasiness	Sadness
Verschwindt, der Geist verschmacht', die Hände sinken mir.	Sadness --- Uneasiness	Sadness

Die Wangen werden bleich, der muntern Augen Zier	Uneasiness --- Sadness	Sadness
Vergeht gleich als der Schein der schon verbrannten Kerzen.	Uneasiness --- Sadness	Sadness
Die Seele wird bestürmt, gleich wie die See im Märtzen.	Uneasiness --- Sadness	Sadness
Was ist dies Leben doch, was sind wir, ich und ihr?	Uneasiness --- Sadness	Sadness --- Awe / Sublime

Was bilden wir uns ein, was wünschen wir zu haben?	Sadness	Sadness --- Awe / Sublime
Itzt sind wir hoch und groß, und morgen schon vergraben;	Sadness	Sadness --- Awe / Sublime
Itzt Blumen, morgen Kot. Wir sind ein Wind, ein Schaum,	Sadness --- Uneasiness	Sadness --- Awe / Sublime

Ein Nebel und ein Bach, ein Reif, ein Tau, ein Schatten;	Sadness	Sadness --- Awe / Sublime
Itzt was und morgen nichts. Und was sind unsre Taten	Sadness	Sadness --- Awe / Sublime
Als ein mit herber Angst durchmischter Traum.	Sadness	Sadness --- Awe / Sublime


John Maynard		

John Maynard!	Suspense	Suspense
"Wer ist John Maynard?"	Suspense	Suspense
"John Maynard war unser Steuermann,	Suspense	Beauty / Joy
aushielt er, bis er das Ufer gewann,	Beauty / Joy	Beauty / Joy
er hat uns gerettet, er trägt die Kron',	Beauty / Joy	Beauty / Joy
er starb für uns, unsre Liebe sein Lohn.	Beauty / Joy	Beauty / Joy
John Maynard."	Beauty / Joy	Beauty / Joy

Die "Schwalbe" fliegt über den Erie-See,	Beauty / Joy	Beauty / Joy
Gischt schäumt um den Bug wie Flocken von Schnee;	Beauty / Joy	Beauty / Joy
von Detroit fliegt sie nach Buffalo -	Beauty / Joy	Beauty / Joy
die Herzen aber sind frei und froh,	Beauty / Joy	Beauty / Joy
und die Passagiere mit Kindern und Fraun	Beauty / Joy	Beauty / Joy
im Dämmerlicht schon das Ufer schaun,	Beauty / Joy	Beauty / Joy
und plaudernd an John Maynard heran	Beauty / Joy	Beauty / Joy
tritt alles: "Wie weit noch, Steuermann?"	Beauty / Joy	Beauty / Joy
Der schaut nach vorn und schaut in die Rund:	Beauty / Joy	Beauty / Joy
"Noch dreißig Minuten ... Halbe Stund."	Beauty / Joy	Beauty / Joy

Alle Herzen sind froh, alle Herzen sind frei -	Beauty / Joy	Beauty / Joy
da klingt's aus dem Schiffsraum her wie Schrei,	Suspense --- Uneasiness	Suspense --- Uneasiness
"Feuer!" war es, was da klang,	Suspense --- Uneasiness	Suspense --- Uneasiness
ein Qualm aus Kajüt und Luke drang,	Suspense --- Uneasiness	Suspense --- Uneasiness
ein Qualm, dann Flammen lichterloh,	Suspense --- Uneasiness	Suspense --- Uneasiness
und noch zwanzig Minuten bis Buffalo.	Suspense --- Uneasiness	Suspense --- Uneasiness

Und die Passagiere, bunt gemengt,	Uneasiness	Suspense --- Uneasiness
am Bugspriet stehn sie zusammengedrängt,	Uneasiness	Suspense --- Uneasiness
am Bugspriet vorn ist noch Luft und Licht,	Uneasiness	Suspense --- Uneasiness
am Steuer aber lagert sich´s dicht,	Uneasiness	Suspense --- Uneasiness
und ein Jammern wird laut: "Wo sind wir? wo?"	Uneasiness	Suspense --- Uneasiness
Und noch fünfzehn Minuten bis Buffalo. -	Suspense	Suspense --- Uneasiness

Der Zugwind wächst, doch die Qualmwolke steht,	Suspense --- Uneasiness	Suspense
der Kapitän nach dem Steuer späht,	Suspense --- Uneasiness	Suspense
er sieht nicht mehr seinen Steuermann,	Suspense --- Uneasiness	Suspense
aber durchs Sprachrohr fragt er an:	Suspense	Suspense
"Noch da, John Maynard?"	Suspense	Suspense
"Ja,Herr. Ich bin."	Suspense	Suspense

"Auf den Strand! In die Brandung!"	Suspense	Suspense
"Ich halte drauf hin."	Suspense	Suspense
Und das Schiffsvolk jubelt: "Halt aus! Hallo!"	Suspense	Suspense
Und noch zehn Minuten bis Buffalo. - -	Suspense	Suspense

"Noch da, John Maynard?" Und Antwort schallt's	Suspense	Suspense
mit ersterbender Stimme: "Ja, Herr, ich halt's!"	Suspense	Suspense
Und in die Brandung, was Klippe, was Stein,	Suspense	Suspense
jagt er die "Schwalbe" mitten hinein.	Suspense	Suspense
Soll Rettung kommen, so kommt sie nur so.	Beauty / Joy	Beauty / Joy
Rettung: der Strand von Buffalo!	Beauty / Joy	Beauty / Joy

Das Schiff geborsten. Das Feuer verschwelt.	Suspense	Suspense
Gerettet alle. Nur einer fehlt!	Suspense	Suspense

Alle Glocken gehn; ihre Töne schwell'n	Sadness	Sadness
himmelan aus Kirchen und Kapell'n,	Sadness	Sadness
ein Klingen und Läuten, sonst schweigt die Stadt,	Sadness	Sadness
ein Dienst nur, den sie heute hat:	Sadness	Sadness
Zehntausend folgen oder mehr,	Sadness	Sadness
und kein Aug' im Zuge, das tränenleer.	Sadness	Sadness

Sie lassen den Sarg in Blumen hinab,	Sadness	Sadness
mit Blumen schließen sie das Grab,	Sadness	Sadness
und mit goldner Schrift in den Marmorstein	Suspense	Sadness
schreibt die Stadt ihren Dankspruch ein:	Suspense	Sadness

"Hier ruht John Maynard! In Qualm und Brand	Beauty / Joy	Beauty / Joy
hielt er das Steuer fest in der Hand,	Beauty / Joy	Beauty / Joy
er hat uns gerettet, er trägt die Kron,	Beauty / Joy	Beauty / Joy
er starb für uns, unsre Liebe sein Lohn.	Beauty / Joy	Beauty / Joy
John Maynard."	Beauty / Joy	Beauty / Joy


Vereinsamt		

Die Krähen schrein	Uneasiness	Uneasiness
Und ziehen schwirren Flugs zur Stadt:	Uneasiness	Uneasiness
Bald wird es schnein, -	Uneasiness	Uneasiness
Wohl dem, der jetzt noch - Heimat hat!	Uneasiness	Uneasiness

Nun stehst du starr,	Sadness	Sadness
Schaust rückwärts, ach! wie lange schon!	Sadness	Sadness
Was bist du Narr	Sadness	Sadness
Vor Winters in die Welt entflohn?	Sadness	Sadness

Die Welt - ein Tor	Sadness	Sadness
Zu tausend Wüsten stumm und kalt!	Sadness	Sadness
Wer das verlor,	Sadness	Sadness
Was du verlorst, macht nirgends Halt.	Sadness	Sadness

Nun stehst du bleich,	Sadness	Sadness
Zur Winter-Wanderschaft verflucht,	Sadness	Sadness
Dem Rauche gleich,	Sadness	Sadness
Der stets nach kältern Himmeln sucht.	Sadness	Sadness

Flieg, Vogel, schnarr	Sadness	Sadness
Dein Lied im Wüstenvogel-Ton! -	Sadness	Sadness
Versteck, du Narr,	Sadness	Sadness
Dein blutend Herz in Eis und Hohn!	Sadness	Sadness

Die Krähen schrein	Uneasiness	Uneasiness
Und ziehen schwirren Flugs zur Stadt:	Uneasiness	Uneasiness
Bald wird es schnein, -	Uneasiness	Uneasiness
Weh dem, der keine Heimat hat!	Uneasiness	Uneasiness


An Sich		

Sei dennoch unverzagt! Gib dennoch unverloren!	Vitality	Vitality
Weich keinem Glücke nicht, steh höher als der Neid,	Vitality	Vitality
vergnüge dich an dir und acht es für kein Leid,	Vitality	Vitality
hat sich gleich wider dich Glück, Ort und Zeit verschworen.	Vitality	Vitality

Was dich betrübt und labt, halt alles für erkoren;	Vitality --- Awe / Sublime	Vitality
nimm dein Verhängnis an. Laß alles unbereut.	Vitality --- Awe / Sublime	Vitality
Tu, was getan muß sein, und eh man dir?s gebeut.	Vitality --- Awe / Sublime	Vitality
Was du noch hoffen kannst, das wird noch stets geboren.	Vitality --- Awe / Sublime	Vitality

Was klagt, was lobt man noch? Sein Unglück und sein Glücke	Beauty / Joy	Vitality
ist ihm ein jeder selbst. Schau alle Sachen an:	Beauty / Joy	Vitality
dies alles ist in dir. Laß deinen eitlen Wahn,	Beauty / Joy	Vitality

und eh du fürder gehst, so geh in dich zurücke.	Awe / Sublime --- Beauty / Joy	Vitality --- Beauty / Joy
Wer sein selbst Meister ist und sich beherrschen kann,	Awe / Sublime --- Beauty / Joy	Vitality --- Beauty / Joy
dem ist die weite Welt und alles untertan.	Awe / Sublime --- Beauty / Joy	Vitality --- Beauty / Joy


Als es Friedrich von Österreich so erging / Dô Friderich ûz Ôsterrîch alsô gewarp		

Dô Friderich ûz Osterrîch alsô gewarp,	Sadness --- Suspense	Sadness
daz er an der sêle genas und im der lîp erstarp,	Sadness --- Suspense	Sadness
dô fuort er mînen krenechen trit in die erde,	Sadness	Sadness
Dô gienc ich slîchent als ein pfawe, swar ich gie,	Sadness	Sadness
daz houbet hanht ich nider unz ûf mîniu knie,	Sadness	Sadness
nû riht ich ez ûf nâch vollem werde:	Vitality	Vitality
ich bin wol ze fiure komen,	Vitality	Vitality
mich hât daz rîche und ouch diu krône an sich genomen,	Vitality	Vitality
wol ûf, swer tanzen welle nâch der gîgen!	Vitality	Vitality
mir ist mîner swære buoz,	Vitality	Vitality
êrste wil ich eben setzen mînen fuoz	Vitality	Vitality
und wider in ein hôhgemüete stîgen.	Vitality	Vitality


Siehst du die Stadt		

Siehst du die Stadt, wie sie da drüben ruht,	Beauty / Joy --- Suspense	Beauty / Joy
Sich flüsternd schmieget in das Kleid der Nacht?	Beauty / Joy --- Suspense	Beauty / Joy
Es gießt der Mond der Silberseide Flut	Beauty / Joy	Beauty / Joy
Auf sie herab in zauberischer Pracht.	Beauty / Joy	Beauty / Joy

Der laue Nachtwind weht ihr Atmen her,	Beauty / Joy	Uneasiness
So geisterhaft, verlöschend leisen Klang:	Beauty / Joy	Uneasiness
Sie weint im Traum, sie atmet tief und schwer,	Beauty / Joy --- Sadness	Uneasiness
Sie lispelt, rätselvoll, verlockend bang ...	Beauty / Joy --- Sadness	Uneasiness

Die dunkle Stadt, sie schläft im Herzen mein	Beauty / Joy	Beauty / Joy
Mit Glanz und Glut, mit qualvoll bunter Pracht:	Beauty / Joy	Beauty / Joy
Doch schmeichelnd schwebt um dich ihr Widerschein,	Beauty / Joy	Beauty / Joy
Gedämpft zum Flüstern, gleitend durch die Nacht.	Beauty / Joy	Beauty / Joy


Regen in der Dämmerung		

Der wandernde Wind auf den Wegen	Beauty / Joy	Beauty / Joy
War angefüllt mit süßem Laut,	Beauty / Joy	Beauty / Joy
Der dämmernde rieselnde Regen	Beauty / Joy	Beauty / Joy
War mit Verlangen feucht betaut.	Beauty / Joy	Beauty / Joy

Das rinnende rauschende Wasser	Beauty / Joy --- Sadness	Beauty / Joy
Berauschte verwirrend die Stimmen	Beauty / Joy --- Sadness	Beauty / Joy
Der Träume, die blasser und blasser	Beauty / Joy --- Sadness	Beauty / Joy --- Sadness
Im schwebenden Nebel verschwimmen.	Beauty / Joy --- Sadness	Beauty / Joy --- Sadness

Der Wind in den wehenden Weiden,	Beauty / Joy	Beauty / Joy
Am Wasser der wandernde Wind	Beauty / Joy	Beauty / Joy
Berauschte die sehnenden Leiden,	Beauty / Joy	Beauty / Joy
Die in der Dämmerung sind.	Beauty / Joy	Beauty / Joy

Der Weg im dämmernden Wehen,	Sadness	Sadness
Er führte zu keinem Ziel,	Sadness	Sadness
Doch war er gut zu gehen	Beauty / Joy --- Sadness	Sadness
Im Regen, der rieselnd fiel.	Beauty / Joy --- Sadness	Sadness


Ebenbild unseres Lebens		

Der Mensch, das Spiel der Zeit, spielt, weil er allhie lebt	Sadness --- Awe / Sublime	Awe / Sublime
im Schauplatz dieser Welt; er sitzt, und doch nicht feste.	Sadness --- Awe / Sublime	Awe / Sublime
Der steigt, und jener fällt, der suchet die Paläste	Sadness --- Awe / Sublime	Awe / Sublime
und der ein schlechtes Dach; der herrscht, und jener webt.	Sadness --- Awe / Sublime	Awe / Sublime

Was gestern war, ist hin; was itzt das Glück erhebt,	Sadness	Sadness
wird morgen untergehn; die vorhin grüne Äste	Sadness	Sadness
sind nunmehr dürr und tot; wir Armen sind nur Gäste,	Sadness	Sadness
ob den' ein scharfes Schwert an zarter Seide schwebt.	Sadness --- Uneasiness	Sadness

Wir sind zwar gleich am Fleisch, doch nicht vom gleichem Stande:	Awe / Sublime --- Sadness	Awe / Sublime --- Sadness
Der trägt ein Purpurkleid, und jener gräbt im Sande,	Awe / Sublime --- Sadness	Awe / Sublime --- Sadness
bis nach entraubtem Schmuck der Tod uns gleiche macht.	Awe / Sublime --- Sadness	Awe / Sublime --- Sadness

Spielt denn dies ernste Spiel, weil es die Zeit noch leidet,	Awe / Sublime	Awe / Sublime
und lernt, dass wenn man vom Bankett des Lebens scheidet,	Awe / Sublime	Awe / Sublime
Kron, Weisheit, Stärk und Gut sei eine leere Pracht!	Awe / Sublime	Awe / Sublime


Todeserfahrung		

Wir wissen nichts von diesem Hingehn, das	Awe / Sublime	Awe / Sublime
nicht mit uns teilt. Wir haben keinen Grund,	Awe / Sublime	Awe / Sublime
Bewunderung und Liebe oder Haß	Awe / Sublime	Awe / Sublime
dem Tod zu zeigen, den ein Maskenmund	Awe / Sublime	Awe / Sublime

tragischer Klage wunderlich entstellt.	Sadness --- Awe / Sublime	Awe / Sublime
Noch ist die Welt voll Rollen, die wir spielen.	Sadness --- Awe / Sublime	Sadness
Solang wir sorgen, ob wir auch gefielen,	Sadness --- Awe / Sublime	Awe / Sublime
spielt auch der Tod, obwohl er nicht gefällt.	Sadness --- Awe / Sublime	Awe / Sublime

Doch als du gingst, da brach in diese Bühne	Awe / Sublime --- Beauty / Joy	Beauty / Joy
ein Streifen Wirklichkeit durch jenen Spalt	Awe / Sublime --- Beauty / Joy	Beauty / Joy
durch den du hingingst: Grün wirklicher Grüne,	Awe / Sublime --- Beauty / Joy	Beauty / Joy
wirklicher Sonnenschein, wirklicher Wald.	Awe / Sublime --- Beauty / Joy	Beauty / Joy

Wir spielen weiter. Bang und schwer Erlerntes	Sadness	Sadness
hersagend und Gebärden dann und wann	Sadness	Sadness
aufhebend; aber dein von uns entferntes,	Sadness	Sadness
aus unserm Stück entrücktes Dasein kann	Sadness	Sadness

uns manchmal überkommen, wie ein Wissen	Beauty / Joy --- Awe / Sublime	Beauty / Joy --- Awe / Sublime
von jener Wirklichkeit sich niedersenkend,	Beauty / Joy --- Awe / Sublime	Beauty / Joy --- Awe / Sublime
so daß wir eine Weile hingerissen	Beauty / Joy --- Awe / Sublime	Beauty / Joy --- Awe / Sublime
das Leben spielen, nicht an Beifall denkend.	Beauty / Joy --- Awe / Sublime	Beauty / Joy --- Awe / Sublime


Papageien-Park		

Unter türkischen Linden, die blühen, an Rasenrändern,	Beauty / Joy	Beauty / Joy
in leise von ihrem Heimweh geschaukelten Ständern	Beauty / Joy	Beauty / Joy
atmen die Ara und wissen von ihren Ländern,	Beauty / Joy --- Sadness	Sadness --- Beauty / Joy
die sich, auch wenn sie nicht hinsehn, nicht verändern.	Beauty / Joy --- Sadness	Sadness --- Beauty / Joy

Fremd im beschäftigten Grünen wie eine Parade,	Beauty / Joy	Beauty / Joy
zieren sie sich und fühlen sich selber zu schade,	Beauty / Joy	Beauty / Joy
und mit den kostbaren Schnäbeln aus Jaspis und Jade	Beauty / Joy	Beauty / Joy
kauen sie Graues, verschleudern es, finden es fade.	Beauty / Joy	Beauty / Joy

Unten klauben die duffen Tauben, was sie nicht mögen,	Sadness	Sadness
während sich oben die höhnischen Vögel verbeugen	Sadness	Sadness
zwischen den beiden fast leeren vergeudeten Trögen.	Humor	Sadness

Aber dann wiegen sie wieder und schläfern und äugen,	Beauty / Joy	Beauty / Joy
spielen mit dunkelen Zungen, die gerne lögen,	Uneasiness	Uneasiness
zerstreut an den Fußfesselringen. Warten auf Zeugen.	Uneasiness	Uneasiness


Morgensonett		

Die ewighelle Schar will nun ihr Licht verschließen;	Vitality	Vitality
Diana steht erblaßt; die Morgenröte lacht	Vitality	Vitality
Den grauen Himmel an, der sanfte Wind erwacht	Vitality	Vitality
Und reizt das Federvolk, den neuen Tag zu grüßen.	Vitality	Vitality

Das Leben dieser Welt eilt schon die Welt zu küssen	Beauty / Joy	Vitality --- Beauty / Joy
Und steckt sein Haupt empor; man sieht der Strahlen Pracht	Beauty / Joy	Vitality --- Beauty / Joy
Nun blinkern auf der See. O dreimal höchste Macht!	Beauty / Joy --- Awe / Sublime	Vitality --- Beauty / Joy
Erleuchte den, der sich jetzt beugt vor deinen Füßen!	Beauty / Joy --- Awe / Sublime	Vitality --- Beauty / Joy

Vertreib die dicke Nacht, die meine Seel umgibt,	Vitality	Vitality
Die Schmerzensfinsternis, die Herz und Geist betrübt!	Vitality	Vitality
Erquicke mein Gemüt und stärke mein Vertrauen!	Vitality	Vitality

Gib, daß ich diesen Tag in deinem Dienst allein	Awe / Sublime --- Vitality	Vitality
Zubring! und wenn mein End und jener Tag bricht ein,	Awe / Sublime --- Vitality	Vitality
Daß ich dich, meine Sonn! mein Licht! mög ewig schauen!	Awe / Sublime --- Vitality	Vitality


Der Krieg		

Aufgestanden ist er, welcher lange schlief,	Uneasiness --- Suspense	Suspense
Aufgestanden unten aus Gewölben tief.	Uneasiness --- Suspense	Suspense
In der Dämmrung steht er, groß und unerkannt,	Uneasiness	Suspense --- Uneasiness
Und den Mond zerdrückt er in der schwarzen Hand.	Uneasiness	Suspense --- Uneasiness

In den Abendlärm der Städte fällt es weit,	Uneasiness	Uneasiness
Frost und Schatten einer fremden Dunkelheit,	Uneasiness	Uneasiness
Und der Märkte runder Wirbel stockt zu Eis.	Uneasiness	Uneasiness
Es wird still. Sie sehn sich um. Und keiner weiß.	Uneasiness	Uneasiness

In den Gassen faßt es ihre Schulter leicht.	Uneasiness	Uneasiness
Eine Frage. Keine Antwort. Ein Gesicht erbleicht.	Uneasiness	Uneasiness
In der Ferne wimmert ein Geläute dünn	Uneasiness	Uneasiness
Und die Bärte zittern um ihr spitzes Kinn.	Uneasiness	Uneasiness

Auf den Bergen hebt er schon zu tanzen an	Uneasiness	Uneasiness
Und er schreit: Ihr Krieger alle, auf und an.	Uneasiness	Uneasiness
Und es schallet, wenn das schwarze Haupt er schwenkt,	Uneasiness	Uneasiness
Drum von tausend Schädeln laute Kette hängt.	Uneasiness	Uneasiness

Einem Turm gleich tritt er aus die letzte Glut,	Uneasiness	Uneasiness
Wo der Tag flieht, sind die Ströme schon voll Blut.	Uneasiness	Uneasiness
Zahllos sind die Leichen schon im Schilf gestreckt,	Uneasiness	Uneasiness
Von des Todes starken Vögeln weiß bedeckt.	Uneasiness	Uneasiness

Über runder Mauern blauem Flammenschwall	Uneasiness	Uneasiness
Steht er, über schwarzer Gassen Waffenschall.	Uneasiness	Uneasiness
Über Toren, wo die Wächter liegen quer,	Uneasiness	Uneasiness
Über Brücken, die von Bergen Toter schwer.	Uneasiness	Uneasiness

In der Nacht er jagt das Feuer querfeldein	Uneasiness	Uneasiness
einen roten Hund mit wilder Mäuler Schrein.	Uneasiness	Uneasiness
Aus dem Dunkel springt der Nächte schwarze Welt,	Uneasiness	Uneasiness
Von Vulkanen furchtbar ist ihr Rand erhellt.	Uneasiness	Uneasiness

Und mit tausend roten Zipfelmützen weit	Uneasiness	Uneasiness
Sind die finstren Ebnen flackend überstreut,	Uneasiness	Uneasiness
Und was unten auf den Straßen wimmelt hin und her,	Uneasiness	Uneasiness
Fegt er in die Feuerhaufen, daß die Flamme brenne mehr.	Uneasiness	Uneasiness

Und die Flammen fressen brennend Wald um Wald,	Uneasiness	Uneasiness
Gelbe Fledermäuse zackig in das Laub gekrallt.	Uneasiness	Uneasiness
Seine Stange haut er wie ein Köhlerknecht	Uneasiness	Uneasiness
In die Bäume, daß das Feuer brause recht.	Uneasiness	Uneasiness

Eine große Stadt versank in gelbem Rauch,	Uneasiness	Uneasiness
Warf sich lautlos in des Abgrunds Bauch.	Uneasiness	Uneasiness
Aber riesig über glühnden Trümmern steht	Uneasiness --- Awe / Sublime	Awe / Sublime
Der in wilde Himmel dreimal seine Fackel dreht,	Uneasiness --- Awe / Sublime	Awe / Sublime

Über sturmzerfetzter Wolken Widerschein,	Uneasiness	Awe / Sublime --- Uneasiness
In des toten Dunkels kalten Wüstenein,	Uneasiness	Awe / Sublime --- Uneasiness
Daß er mit dem Brande weit die Nacht verdorr,	Uneasiness	Awe / Sublime --- Uneasiness
Pech und Feuer träufet unten auf Gomorrh.	Uneasiness	Awe / Sublime --- Uneasiness


Die Dämonen der Stadt		

Sie wandern durch die Nacht der Städte hin,	Uneasiness --- Suspense	Uneasiness --- Suspense
Die schwarz sich ducken unter ihrem Fuß.	Uneasiness --- Suspense	Uneasiness --- Suspense
Wie Schifferbärte stehen um ihr Kinn	Uneasiness --- Suspense	Uneasiness --- Suspense
Die Wolken schwarz vom Rauch und Kohlenruß.	Uneasiness --- Suspense	Uneasiness --- Suspense

Ihr langer Schatten schwankt im Häusermeer	Uneasiness	Uneasiness
Und löscht der Straßen Lichterreihen aus.	Uneasiness	Uneasiness
Er kriecht wie Nebel auf dem Pflaster schwer	Uneasiness	Uneasiness
Und tastet langsam vorwärts Haus für Haus.	Uneasiness	Uneasiness

Den einen Fuß auf einen Platz gestellt,	Uneasiness	Uneasiness
Den anderen gekniet auf einen Turm,	Uneasiness	Uneasiness
Ragen sie auf, wo schwarz der Regen fällt,	Uneasiness	Uneasiness
Panspfeifen blasend in den Wolkensturm.	Uneasiness	Uneasiness

Um ihre Füße kreist das Ritornell	Uneasiness --- Sadness	Uneasiness
Des Städtemeers mit trauriger Musik,	Uneasiness --- Sadness	Uneasiness
Ein großes Sterbelied. Bald dumpf, bald grell	Uneasiness --- Sadness	Uneasiness
Wechselt der Ton, der in das Dunkel stieg.	Uneasiness --- Sadness	Uneasiness

Sie wandern an dem Strom, der schwarz und breit	Uneasiness	Uneasiness
Wie ein Reptil, den Rücken gelb gefleckt	Uneasiness	Uneasiness
Von den Laternen, in die Dunkelheit	Uneasiness	Uneasiness
Sich traurig wälzt, die schwarz den Himmel deckt.	Uneasiness --- Sadness	Uneasiness

Sie lehnen schwer auf einer Brückenwand	Uneasiness	Uneasiness
Und stecken ihre Hände in den Schwarm	Uneasiness	Uneasiness
Der Menschen aus, wie Faune, die am Rand	Uneasiness	Uneasiness
Der Sümpfe bohren in den Schlamm den Arm.	Uneasiness	Uneasiness

Einer steht auf. Dem weißen Monde hängt	Uneasiness	Uneasiness
Er eine schwarze Larve vor. Die Nacht,	Uneasiness	Uneasiness
Die sich wie Blei vom finstern Himmel senkt,	Uneasiness	Uneasiness
Drückt tief die Häuser in des Dunkels Schacht.	Uneasiness	Uneasiness

Der Städte Schultern knacken. Und es birst	Uneasiness	Uneasiness
Ein Dach, daraus ein rotes Feuer schwemmt.	Uneasiness	Uneasiness
Breitbeinig sitzen sie auf seinem First	Uneasiness	Uneasiness
Und schrein wie Katzen auf zum Firmament.	Uneasiness	Uneasiness

In einer Stube voll von Finsternissen	Uneasiness	Uneasiness --- Suspense
Schreit eine Wöchnerin in ihren Wehn.	Uneasiness	Uneasiness --- Suspense
Ihr starker Leib ragt riesig aus den Kissen,	Uneasiness	Uneasiness
Um den herum die großen Teufel stehn.	Uneasiness	Uneasiness

Sie hält sich zitternd an der Wehebank.	Uneasiness	Uneasiness
Das Zimmer schwankt um sie von ihrem Schrei,	Uneasiness	Uneasiness
Da kommt die Frucht. Ihr Schoß klafft rot und lang	Uneasiness	Uneasiness
Und blutend reißt er von der Frucht entzwei.	Uneasiness	Uneasiness

Der Teufel Hälse wachsen wie Giraffen.	Uneasiness	Uneasiness
Das Kind hat keinen Kopf. Die Mutter hält	Uneasiness	Uneasiness
Es vor sich hin. In ihrem Rücken klaffen	Uneasiness	Uneasiness
Des Schrecks Froschfinger, wenn sie rückwärts fällt.	Uneasiness	Uneasiness

Doch die Dämonen wachsen riesengroß.	Uneasiness	Uneasiness
Ihr Schläfenhorn zerreißt den Himmel rot.	Uneasiness	Uneasiness
Erdbeben donnert durch der Städte Schoß	Uneasiness	Uneasiness
Um ihren Huf, den Feuer überloht.	Uneasiness	Uneasiness


In den Nachmittag geflüstert		

Sonne, herbstlich dünn und zag,	Beauty / Joy	Beauty / Joy
Und das Obst fällt von den Bäumen.	Beauty / Joy	Beauty / Joy
Stille wohnt in blauen Räumen	Beauty / Joy	Beauty / Joy
Einen langen Nachmittag.	Beauty / Joy	Beauty / Joy

Sterbeklänge von Metall;	Sadness	Sadness
Und ein weißes Tier bricht nieder.	Sadness	Sadness
Brauner Mädchen rauhe Lieder	Sadness	Sadness
Sind verweht im Blätterfall.	Sadness	Sadness

Stirne Gottes Farben träumt,	Beauty / Joy	Beauty / Joy
Spürt des Wahnsinns sanfte Flügel.	Uneasiness	Uneasiness
Schatten drehen sich am Hügel	Uneasiness	Uneasiness
Von Verwesung schwarz umsäumt.	Uneasiness	Uneasiness

Dämmerung voll Ruh und Wein;	Beauty / Joy	Beauty / Joy
Traurige Guitarren rinnen.	Beauty / Joy	Beauty / Joy
Und zur milden Lampe drinnen	Beauty / Joy	Beauty / Joy
Kehrst du wie im Traume ein.	Beauty / Joy	Beauty / Joy


Psalm		

Es ist ein Licht, das der Wind ausgelöscht hat.	Sadness	Suspense
Es ist ein Heidekrug, den am Nachmittag ein Betrunkener verläßt.	Sadness	Suspense
Es ist ein Weinberg, verbrannt und schwarz mit Löchern voll Spinnen.	Sadness --- Uneasiness	Suspense
Es ist ein Raum, den sie mit Milch getüncht haben.	Sadness --- Uneasiness	Suspense
Der Wahnsinnige ist gestorben. Es ist eine Insel der Südsee,	Uneasiness	Uneasiness
Den Sonnengott zu empfangen. Man rührt die Trommeln.	Uneasiness	Uneasiness
Die Männer führen kriegerische Tänze auf.	Uneasiness	Uneasiness
Die Frauen wiegen die Hüften in Schlinggewächsen und Feuerblumen,	Uneasiness	Uneasiness
Wenn das Meer singt. O unser verlorenes Paradies.	Uneasiness --- Sadness	Sadness

Die Nymphen haben die goldenen Wälder verlassen.	Sadness	Sadness
Man begräbt den Fremden. Dann hebt ein Flimmerregen an.	Sadness	Sadness
Der Sohn des Pan erscheint in Gestalt eines Erdarbeiters,	Sadness	Beauty / Joy
Der den Mittag am glühenden Asphalt verschläft.	Sadness	Beauty / Joy
Es sind kleine Mädchen in einem Hof in Kleidchen voll herzzerreißender Armut.	Sadness	Sadness
Es sind Zimmer, erfüllt von Akkorden und Sonaten.	Sadness	Sadness
Es sind Schatten, die sich vor einem erblindeten Spiegel umarmen.	Sadness	Sadness
An den Fenstern des Spitals wärmen sich Genesende.	Sadness	Uneasiness
Ein weißer Dampfer am Kanal trägt blutige Seuchen herauf.	Uneasiness	Uneasiness

Die fremde Schwester erscheint wieder in jemands bösen Träumen.	Uneasiness	Uneasiness
Ruhend im Haselgebüsch spielt sie mit seinen Schatten.	Uneasiness	Uneasiness
Der Student, vielleicht ein Doppelgänger, schaut ihr lange vom Fenster nach.	Uneasiness	Uneasiness
Hinter ihm steht sein toter Bruder, oder er geht die alte Wendeltreppe herab.	Uneasiness	Uneasiness
Im Dunkel brauner Kastanien verblaßt die Gestalt des jungen Novizen.	Uneasiness	Uneasiness
Der Garten ist im Abend. Im Kreuzgang flattern die Fledermäuse umher.	Uneasiness --- Beauty / Joy	Uneasiness
Die Kinder des Hausmeisters hören zu spielen auf und suchen das Gold des Himmels.	Uneasiness --- Beauty / Joy	Uneasiness
Endakkorde eines Quartetts. Die kleine Blinde läuft zitternd durch die Allee,	Uneasiness --- Beauty / Joy	Uneasiness
Und später tastet ihr Schatten an kalten Mauern hin, umgeben vom Märchen und heiligen Legenden.	Uneasiness --- Beauty / Joy	Uneasiness

Es ist ein leeres Boot, das am Abend den schwarzen Kanal heruntertreibt.	Uneasiness	Sadness
In der Düsternis des alten Asyls verfallen menschliche Ruinen.	Uneasiness	Uneasiness
Die toten Waisen liegen an der Gartenmauer.	Uneasiness	Uneasiness
Aus grauen Zimmern treten Engel mit kotgefleckten Flügeln.	Uneasiness	Uneasiness
Würmer tropfen von ihren vergilbten Lidern.	Uneasiness	Uneasiness
Der Platz vor der Kirche ist finster und schweigsam, wie in den Tagen der Kindheit.	Uneasiness --- Sadness	Uneasiness --- Sadness
Auf silbernen Sohlen gleiten frühere Leben vorbei	Uneasiness --- Sadness	Uneasiness --- Sadness
Und die Schatten der Verdammten steigen zu den seufzenden Wassern nieder.	Uneasiness --- Sadness	Uneasiness --- Sadness
In seinem Grab spielt der weiße Magier mit seinen Schlangen.	Uneasiness --- Sadness	Uneasiness --- Sadness
Schweigsam über der Schädelstätte öffnen sich Gottes goldene Augen.	Uneasiness --- Awe / Sublime	Awe / Sublime --- Uneasiness


Im Winter		

Der Acker leuchtet weiß und kalt.	Uneasiness	Uneasiness
Der Himmel ist einsam und ungeheuer.	Uneasiness	Uneasiness
Dohlen kreisen über dem Weiher	Uneasiness	Uneasiness
Und Jäger steigen nieder vom Wald.	Uneasiness	Uneasiness

Ein Schweigen in schwarzen Wipfeln wohnt.	Beauty / Joy	Beauty / Joy
Ein Feuerschein huscht aus den Hütten.	Beauty / Joy	Beauty / Joy
Bisweilen schellt sehr fern ein Schlitten	Beauty / Joy	Beauty / Joy
Und langsam steigt der graue Mond.	Beauty / Joy	Beauty / Joy

Ein Wild verblutet sanft am Rain	Sadness	Sadness
Und Raben plätschern in blutigen Gossen.	Sadness	Sadness
Das Rohr bebt gelb und aufgeschossen.	Uneasiness	Sadness
Frost, Rauch, ein Schritt im leeren Hain.	Uneasiness	Sadness


In der Welt		

Ich lasse mein Gesicht auf Sterne fallen,	Beauty / Joy	Beauty / Joy
Die wie getroffen auseinander hinken.	Beauty / Joy	Beauty / Joy
Die Wälder wandern mondwärts, schwarze Quallen,	Beauty / Joy	Beauty / Joy
Ins Blaumeer, daraus meine Blicke winken.	Beauty / Joy	Beauty / Joy

Mein Ich ist fort. Es macht die Sternenreise.	Sadness	Sadness
Das ist nicht Ich, wovon die Kleider scheinen.	Sadness	Sadness
Die Tage sterben weg, die weißen Greise.	Sadness	Sadness
Ichlose Nerven sind voll Furcht und weinen.	Sadness	Sadness


Traum		

Durch die Büsche winden Sterne	Vitality	Beauty / Joy --- Vitality
Augen tauchen blaken sinken	Vitality	Beauty / Joy --- Vitality
Flüstern plätschert	Vitality	Beauty / Joy --- Vitality
Blüten gehren	Vitality	Beauty / Joy --- Vitality
Düfte spritzen	Vitality	Beauty / Joy --- Vitality
Schauer stürzen	Vitality	Beauty / Joy --- Vitality
Winde schnellen prellen schwellen	Vitality --- Uneasiness	Beauty / Joy --- Vitality
Tücher reißen	Vitality --- Uneasiness	Beauty / Joy --- Vitality
Fallen schrickt in tiefe Nacht.	Vitality --- Uneasiness	Beauty / Joy --- Vitality


Patrouille		

Die Steine feinden	Uneasiness	Uneasiness
Fenster grinst Verrat	Uneasiness	Uneasiness
Äste würgen	Uneasiness	Uneasiness
Berge Sträucher blättern raschlig	Uneasiness	Uneasiness
gellen	Uneasiness	Uneasiness
Tod.	Uneasiness	Uneasiness


Under der linden		

Under der linden	Beauty / Joy	Sadness
An der heide	Beauty / Joy	Sadness
Da unser zweier bette was.	Beauty / Joy	Sadness
Da mugt ir vinden	Beauty / Joy	Sadness
Schône beide	Beauty / Joy	Sadness
Gebrochen bluomen unde gras,	Beauty / Joy	Sadness
vor dem walde in einem tal.	Beauty / Joy	Sadness
Tandaradei,	Beauty / Joy	Sadness
schône sanc diu nahtegal.	Beauty / Joy	Sadness

Ich kam gegangen	Suspense	Beauty / Joy
Zuo der Ouwe:	Suspense	Beauty / Joy
Dô was mîn friedel komen ê	Beauty / Joy	Beauty / Joy
Dá war ich empfangen,	Beauty / Joy	Beauty / Joy
hêre frouwe	Beauty / Joy	Beauty / Joy
daz ich bin saelic iemer mê.	Beauty / Joy	Beauty / Joy
Kuste er mich? Wol tûsentstunt:	Beauty / Joy	Beauty / Joy
Tandaradei,	Beauty / Joy	Beauty / Joy
seht wie rôt mir ist der unt.	Beauty / Joy	Beauty / Joy

Do het er gemachet	Beauty / Joy	Beauty / Joy
Alsô rîche	Beauty / Joy	Beauty / Joy
Von bluomen eine bettstat.	Beauty / Joy	Beauty / Joy
Des wirt noch gelachet	Beauty / Joy	Beauty / Joy
Innecliche,	Beauty / Joy	Beauty / Joy
kumt iemen an daz selbe pfat.	Beauty / Joy	Beauty / Joy
Bî den rôsen er wol mac	Beauty / Joy	Beauty / Joy
Tandaradei,	Beauty / Joy	Beauty / Joy
merken wâ mirz houbet lac.	Beauty / Joy	Beauty / Joy

Daz er bi mir laege,	Beauty / Joy	Beauty / Joy
wessez iemen	Beauty / Joy	Beauty / Joy
(no enwelle got!), sô schamt ich mich.	Beauty / Joy	Beauty / Joy
Wes er mit mir pflaege,	Beauty / Joy	Beauty / Joy
niemer niemen	Beauty / Joy	Beauty / Joy
bevinde daz wan er und ich-	Beauty / Joy	Beauty / Joy
und ein kleinez vogellîn	Humor --- Beauty / Joy	Humor
tandaradei,	Humor --- Beauty / Joy	Humor
daz mac wol getriuwe sin.	Humor --- Beauty / Joy	Humor


An Schwager Kronos		

Spude dich, Kronos!	Suspense --- Vitality	Suspense --- Vitality
Fort den rasselnden Trott!	Suspense --- Vitality	Suspense --- Vitality
Bergab gleitet der Weg;	Suspense --- Vitality	Suspense --- Vitality
Ekles Schwindeln zögert	Vitality	Vitality
Mir vor die Stirne dein Haudern.	Vitality	Vitality
Frisch den holpernden	Vitality	Vitality
Stock, Wurzeln, Steine den Trott	Vitality	Vitality
Rasch ins Leben hinein!	Vitality	Vitality

Nun schon wieder	Vitality	Vitality
Den eratmenden Schritt	Vitality	Vitality
Mühsam Berg hinauf.	Vitality	Vitality
Auf denn, nicht träge denn!	Vitality	Vitality
Strebend und hoffend an.	Vitality	Vitality

Weit, hoch, herrlich der Blick	Beauty / Joy	Vitality
Rings ins Leben hinein;	Beauty / Joy	Vitality
Vom Gebürg zum Gebürg,	Beauty / Joy --- Awe / Sublime	Awe / Sublime --- Vitality
Über der ewige Geist	Beauty / Joy --- Awe / Sublime	Awe / Sublime --- Vitality
Ewigen Lebens ahndevoll.	Beauty / Joy --- Awe / Sublime	Awe / Sublime --- Vitality

Seitwärts des Überdachs Schatten	Vitality --- Suspense	Suspense
Zieht dich an	Vitality --- Suspense	Suspense
Und der Frischung verheißende Blick	Vitality --- Suspense	Suspense
Auf der Schwelle des Mädchens da.	Vitality --- Suspense	Suspense
Labe dich! ? Mir auch, Mädchen,	Vitality	Vitality
Diesen schäumenden Trunk	Vitality	Vitality
Und den freundlichen Gesundheitsblick!	Vitality	Vitality

Ab dann, frischer hinab!	Vitality	Vitality
Sieh, die Sonne sinkt!	Vitality	Vitality
Eh sie sinkt, eh mich faßt	Uneasiness	Vitality
Greisen im Moore Nebelduft,	Uneasiness	Uneasiness
Entzahnte Kiefer schnattern	Uneasiness	Uneasiness
Und das schlockernde Gebein ?.	Uneasiness	Uneasiness

Trunknen vom letzten Strahl	Uneasiness --- Awe / Sublime	Uneasiness --- Awe / Sublime
Reiß mich, ein Feuermeer	Uneasiness --- Awe / Sublime	Uneasiness --- Awe / Sublime
Mir im schäumenden Aug,	Uneasiness --- Awe / Sublime	Uneasiness --- Awe / Sublime
Mich Geblendeten, Taumelnden	Uneasiness --- Awe / Sublime	Uneasiness --- Awe / Sublime
In der Hölle nächtliches Tor.	Awe / Sublime --- Uneasiness	Uneasiness --- Awe / Sublime

Töne, Schwager, dein Horn,	Awe / Sublime --- Vitality	Vitality --- Awe / Sublime
Raßle den schallenden Trab,	Awe / Sublime --- Vitality	Vitality --- Awe / Sublime
Daß der Orkus vernehme: ein Fürst kommt,	Awe / Sublime --- Vitality	Vitality --- Awe / Sublime
Drunten von ihren Sitzen	Awe / Sublime --- Vitality	Vitality --- Awe / Sublime
Sich die Gewaltigen lüften.	Awe / Sublime --- Vitality	Vitality --- Awe / Sublime


Faust I, Der König in Thule		

Es war einst ein König in Thule,	Beauty / Joy	Beauty / Joy
Gar treu bis an das Grab,	Beauty / Joy	Beauty / Joy
Dem sterbend seine Buhle	Beauty / Joy	Beauty / Joy
einen goldnen Becher gab.	Beauty / Joy	Beauty / Joy

Es ging ihm nichts darüber,	Uneasiness	Beauty / Joy
Er leert' ihn jeden Schmaus;	Uneasiness	Beauty / Joy
Die Augen gingen ihm über,	Uneasiness	Beauty / Joy
So oft er trank daraus.	Uneasiness	Beauty / Joy

Und als er kam zu sterben,	Suspense	Beauty / Joy
Zählt' er seine Städt' im Reich,	Suspense	Beauty / Joy
Gönnt' alles seinen Erben,	Suspense	Beauty / Joy
Den Becher nicht zugleich.	Suspense	Beauty / Joy

Er saß beim Königsmahle,	Beauty / Joy	Beauty / Joy
Die Ritter um ihn her,	Beauty / Joy	Beauty / Joy
Auf hohem Vätersaale	Beauty / Joy	Beauty / Joy
Dort auf dem Schloß am Meer.	Beauty / Joy	Beauty / Joy

Dort stand der alte Zecher,	Suspense	Suspense
Trank letzte Lebensglut	Suspense	Suspense
Und warf den heil'gen Becher	Suspense	Suspense
Hinunter in die Flut.	Suspense	Suspense

Er sah ihn stürzen, trinken	Sadness	Suspense
Und sinken tief ins Meer.	Sadness	Suspense
Die Augen täten ihm sinken,	Sadness	Sadness
Trank nie einen Tropfen mehr.	Sadness	Sadness


An den Mond		

Füllest wieder Busch und Thal	Beauty / Joy	Beauty / Joy
Still mit Nebelglanz,	Beauty / Joy	Beauty / Joy
Lösest endlich auch einmal	Beauty / Joy	Beauty / Joy
Meine Seele ganz;	Beauty / Joy	Beauty / Joy

Breitest über mein Gefild	Beauty / Joy	Beauty / Joy
Lindernd deinen Blick,	Beauty / Joy	Beauty / Joy
Wie des Freundes Auge mild	Beauty / Joy	Beauty / Joy
Über mein Geschick.	Beauty / Joy	Beauty / Joy

Jeden Nachklang fühlt mein Herz	Sadness --- Beauty / Joy	Sadness
Froh und trüber Zeit,	Sadness --- Beauty / Joy	Sadness
Wandle zwischen Freud? und Schmerz	Sadness --- Beauty / Joy	Sadness
In der Einsamkeit.	Sadness --- Beauty / Joy	Sadness

Fließe, fließe, lieber Fluß!	Sadness	Sadness
Nimmer werd? ich froh;	Sadness	Sadness
So verrauschte Scherz und Kuß	Sadness	Sadness
Und die Treue so.	Sadness	Sadness

Ich besaß es doch einmal,	Sadness	Sadness
Was so köstlich ist!	Sadness	Sadness
Daß man doch zu seiner Qual	Sadness	Sadness
Nimmer es vergißt!	Sadness	Sadness

Rausche, Fluß, das Tal entlang,	Vitality	Vitality
Ohne Rast und Ruh,	Vitality	Vitality
Rausche, flüstre meinem Sang	Vitality	Vitality
Melodien zu!	Vitality	Vitality

Wenn du in der Winternacht	Beauty / Joy	Beauty / Joy
Wüthend überschwillst	Beauty / Joy	Beauty / Joy
Oder um die Frühlingspracht	Beauty / Joy	Beauty / Joy
Junger Knospen quillst.	Beauty / Joy	Beauty / Joy

Selig, wer sich vor der Welt	Beauty / Joy	Beauty / Joy
Ohne Haß verschließt,	Beauty / Joy	Beauty / Joy
Einen Freund am Busen hält	Beauty / Joy	Beauty / Joy
Und mit dem genießt,	Beauty / Joy	Beauty / Joy

Was, von Menschen nicht gewußt	Beauty / Joy	Beauty / Joy
Oder nicht bedacht,	Beauty / Joy	Beauty / Joy
Durch das Labyrinth der Brust	Beauty / Joy	Beauty / Joy
Wandelt in der Nacht.	Beauty / Joy	Beauty / Joy


Erlkönig / Wer reitet so spät durch Nacht und Wind?		

Wer reitet so spät durch Nacht und Wind?	Suspense	Suspense
Es ist der Vater mit seinem Kind;	Beauty / Joy	Beauty / Joy
Er hat den Knaben wohl in dem Arm,	Beauty / Joy	Beauty / Joy
Er faßt ihn sicher, er hält ihn warm.	Beauty / Joy	Beauty / Joy

Mein Sohn, was birgst du so bang dein Gesicht? -	Uneasiness	Uneasiness
Siehst Vater, du den Erlkönig nicht?	Uneasiness	Uneasiness
Den Erlenkönig mit Kron und Schweif? -	Uneasiness	Uneasiness
Mein Sohn, es ist ein Nebelstreif. -	Uneasiness	Uneasiness

"Du liebes Kind, komm, geh mit mir!	Uneasiness	Uneasiness
Gar schöne Spiele spiel ich mit dir;	Uneasiness	Uneasiness
Manch bunte Blumen sind an dem Strand,	Uneasiness	Uneasiness
Meine Mutter hat manch gülden Gewand."	Uneasiness	Uneasiness

Mein Vater, mein Vater, und hörest du nicht,	Uneasiness	Uneasiness
Was Erlenkönig mir leise verspricht? -	Uneasiness	Uneasiness
Sei ruhig, bleibe ruhig, mein Kind;	Uneasiness	Uneasiness
In dürren Blättern säuselt der Wind. -	Uneasiness	Uneasiness

"Willst, feiner Knabe, du mit mir gehn?	Uneasiness	Uneasiness
Meine Töchter sollen dich warten schön;	Uneasiness	Uneasiness
Meine Töchter führen den nächtlichen Reihn	Uneasiness	Uneasiness
Und wiegen und tanzen und singen dich ein."	Uneasiness	Uneasiness

Mein Vater, mein Vater, und siehst du nicht dort	Uneasiness	Uneasiness
Erlkönigs Töchter am düstern Ort? -	Uneasiness	Uneasiness
Mein Sohn, mein Sohn, ich seh es genau:	Uneasiness	Uneasiness
Es scheinen die alten Weiden so grau. -	Uneasiness	Uneasiness

"Ich liebe dich, mich reizt deine schöne Gestalt;	Uneasiness	Suspense --- Uneasiness
Und bist du nicht willig, so brauch ich Gewalt."	Uneasiness	Suspense --- Uneasiness
Mein Vater, mein Vater, jetzt faßt er mich an!	Uneasiness	Suspense --- Uneasiness
Erlkönig hat mir ein Leids getan! -	Uneasiness	Suspense --- Uneasiness

Dem Vater grauset's, er reitet geschwind,	Uneasiness --- Suspense	Uneasiness --- Suspense
Er hält in den Armen das ächzende Kind,	Uneasiness --- Suspense	Uneasiness --- Suspense
Erreicht den Hof mit Mühe und Not;	Uneasiness --- Suspense	Uneasiness --- Suspense
In seinen Armen das Kind war tot.	Sadness	Uneasiness


Der Zauberlehrling		

Hat der alte Hexenmeister	Beauty / Joy	Beauty / Joy
Sich doch einmal wegbegeben!	Beauty / Joy	Beauty / Joy
Und nun sollen seine Geister	Beauty / Joy	Beauty / Joy
Auch nach meinem Willen leben.	Beauty / Joy	Beauty / Joy
Seine Wort' und Werke	Beauty / Joy	Beauty / Joy
Merkt ich und den Brauch,	Beauty / Joy	Beauty / Joy
Und mit Geistesstärke	Beauty / Joy	Beauty / Joy
Tu ich Wunder auch.	Beauty / Joy	Beauty / Joy

Walle! walle	Vitality	Vitality
Manche Strecke,	Vitality	Vitality
Daß, zum Zwecke,	Vitality	Vitality
Wasser fließe	Vitality	Vitality
Und mit reichem, vollem Schwalle	Vitality	Vitality
Zu dem Bade sich ergieße.	Vitality	Vitality

Und nun komm, du alter Besen!	Vitality --- Humor	Humor
Nimm die schlechten Lumpenhüllen;	Vitality --- Humor	Humor
Bist schon lange Knecht gewesen:	Vitality --- Humor	Humor
Nun erfülle meinen Willen!	Vitality --- Humor	Humor
Auf zwei Beinen stehe,	Vitality --- Humor	Humor
Oben sei ein Kopf,	Vitality --- Humor	Humor
Eile nun und gehe	Vitality	Humor
Mit dem Wassertopf!	Vitality	Humor

Walle! walle	Vitality	Vitality
Manche Strecke,	Vitality	Vitality
Daß, zum Zwecke,	Vitality	Vitality
Wasser fließe	Vitality	Vitality
Und mit reichem, vollem Schwalle	Vitality	Vitality
Zu dem Bade sich ergieße.	Vitality	Vitality

Seht, er läuft zum Ufer nieder,	Vitality	Humor
Wahrlich! ist schon an dem Flusse,	Vitality	Humor
Und mit Blitzesschnelle wieder	Vitality	Humor
Ist er hier mit raschem Gusse.	Vitality	Humor
Schon zum zweiten Male!	Vitality	Beauty / Joy
Wie das Becken schwillt!	Vitality	Beauty / Joy
Wie sich jede Schale	Vitality	Beauty / Joy
Voll mit Wasser füllt!	Vitality	Beauty / Joy

Stehe! stehe!	Vitality	Vitality
Denn wir haben	Vitality	Vitality
Deiner Gaben	Vitality	Vitality
Vollgemessen! ?	Vitality	Vitality
Ach, ich merk es! Wehe! wehe!	Uneasiness	Humor
Hab ich doch das Wort vergessen!	Uneasiness	Humor

Ach, das Wort, worauf am Ende	Humor	Humor
Er das wird, was er gewesen.	Humor	Humor
Ach, er läuft und bringt behende!	Humor	Humor
Wärst du doch der alte Besen!	Humor	Humor
Immer neue Güsse	Humor --- Vitality	Humor --- Vitality
Bringt er schnell herein,	Humor --- Vitality	Humor --- Vitality
Ach! und hundert Flüsse	Vitality --- Humor	Humor --- Vitality
Stürzen auf mich ein.	Vitality --- Humor	Humor --- Vitality

Nein, nicht länger	Humor	Humor
Kann ichs lassen;	Humor	Humor
Will ihn fassen.	Humor	Humor
Das ist Tücke!	Humor	Humor
Ach! nun wird mir immer bänger!	Uneasiness	Humor
Welche Miene! welche Blicke!	Uneasiness	Humor

O, du Ausgeburt der Hölle!	Humor	Humor
Soll das ganze Haus ersaufen?	Humor	Humor
Seh ich über jede Schwelle	Humor	Humor
Doch schon Wasserströme laufen.	Humor	Humor
Ein verruchter Besen,	Humor	Humor
Der nicht hören will!	Humor	Humor
Stock, der du gewesen,	Humor	Humor
Steh doch wieder still!	Humor	Humor

Willsts am Ende	Humor	Vitality
Gar nicht lassen?	Humor	Vitality
Will dich fassen,	Humor	Vitality
Will dich halten	Humor	Vitality
Und das alte Holz behende	Humor	Vitality
Mit dem scharfen Beile spalten.	Humor	Vitality

Seht, da kommt er schleppend wieder!	Suspense	Humor
Wie ich mich nur auf dich werfe,	Suspense	Humor
Gleich, o Kobold, liegst du nieder;	Suspense --- Humor	Humor
Krachend trifft die glatte Schärfe.	Suspense --- Humor	Beauty / Joy
Wahrlich! brav getroffen!	Beauty / Joy	Beauty / Joy
Seht, er ist entzwei!	Beauty / Joy	Beauty / Joy
Und nun kann ich hoffen,	Beauty / Joy	Beauty / Joy
Und ich atme frei!	Beauty / Joy	Beauty / Joy

Wehe! wehe!	Humor	Humor
Beide Teile	Humor	Humor
Stehn in Eile	Humor	Humor
Schon als Knechte	Humor	Humor
Völlig fertig in die Höhe!	Humor	Humor
Helft mir, ach! ihr hohen Mächte!	Humor	Humor

Und sie laufen! Naß und nässer.	Humor	Humor
Wirds im Saal und auf den Stufen.	Humor	Humor
Welch entsetzliches Gewässer!	Humor	Humor
Herr und Meister! hör mich rufen! ?	Humor	Humor
Ach, da kommt der Meister!	Humor	Humor
Herr, die Not ist groß!	Humor	Humor
Die ich rief, die Geister	Humor	Humor
Werd ich nun nicht los.	Humor	Humor

»In die Ecke,	Beauty / Joy	Humor --- Beauty / Joy
Besen! Besen!	Beauty / Joy	Humor --- Beauty / Joy
Seids gewesen.	Beauty / Joy	Humor --- Beauty / Joy
Denn als Geister	Beauty / Joy	Humor --- Beauty / Joy
Ruft euch nur, zu seinem Zwecke,	Beauty / Joy	Humor --- Beauty / Joy
Erst hervor der alte Meister.«	Beauty / Joy	Humor --- Beauty / Joy


Andacht		

Wann das Abendrot die Haine	Beauty / Joy	Beauty / Joy
Mit den Abschiedsflammen küßt,	Beauty / Joy	Beauty / Joy
Wann im prächtgen Morgenscheine	Beauty / Joy	Beauty / Joy
Lerchenklang die Sonne grüßt,	Beauty / Joy	Beauty / Joy

O dann werf ich Jubellieder	Vitality	Vitality
Ins Lobpreisen der Natur,	Vitality	Vitality
Echo spricht die Töne wieder,	Vitality	Vitality
Alles preißt den Ewgen nur.	Vitality	Vitality

Mit den Quellen geht mein Grüßen,	Beauty / Joy	Beauty / Joy
Und das taube Herz in mir	Beauty / Joy	Beauty / Joy
Hat dem Gott erwachen müssen,	Beauty / Joy	Beauty / Joy
Der uns schirmet für und für.	Beauty / Joy	Beauty / Joy

Meereswogen laut erklingen,	Beauty / Joy	Vitality --- Beauty / Joy
In den Wäldern wohnt manch Schall;	Beauty / Joy	Vitality --- Beauty / Joy
Und wir sollten nicht besingen,	Beauty / Joy	Vitality --- Beauty / Joy
Da die Freude überall?	Beauty / Joy	Vitality --- Beauty / Joy


Hälfte des Lebens		

Mit gelben Birnen hänget	Beauty / Joy	Beauty / Joy
Und voll mit wilden Rosen	Beauty / Joy	Beauty / Joy
Das Land in den See,	Beauty / Joy	Beauty / Joy
Ihr holden Schwäne,	Beauty / Joy	Beauty / Joy
Und trunken von Küssen	Beauty / Joy	Beauty / Joy
Tunkt ihr das Haupt	Beauty / Joy	Beauty / Joy
Ins heilignüchterne Wasser.	Beauty / Joy	Beauty / Joy

Weh mir, wo nehm? ich, wenn	Sadness	Sadness
Es Winter ist, die Blumen, und wo	Sadness	Sadness
Den Sonnenschein,	Sadness	Sadness
Und Schatten der Erde?	Sadness	Sadness
Die Mauern stehn	Sadness	Uneasiness
Sprachlos und kalt, im Winde	Sadness	Uneasiness
Klirren die Fahnen.	Sadness	Uneasiness


Laß rauschen Lieb, laß rauschen		

Ich hört ein Sichlein rauschen,	Sadness	Sadness
Wohl rauschen durch das Korn,	Sadness	Sadness
Ich hört ein Mägdlein klagen,	Sadness	Sadness
Sie hätt ihr Lieb verlorn.	Sadness	Sadness

Laß rauschen, Lieb, laß rauschen,	Sadness	Sadness --- Vitality
Ich acht nicht, wie es geht,	Sadness	Sadness --- Vitality
Ich thät mein Lieb vertauschen	Sadness	Sadness --- Vitality
In Veilchen und im Klee.	Sadness	Sadness --- Vitality

Du hast ein Mägdlein worben	Sadness	Sadness
In Veilchen und im Klee,	Sadness	Sadness
So steh ich hier alleine,	Sadness	Sadness
Thut meinem Herzen weh.	Sadness	Sadness

Ich hör ein Hirschlein rauschen	Sadness	Sadness
Wohl rauschen durch den Wald,	Sadness	Sadness
Ich hör mein Lieb sich klagen,	Sadness	Sadness
Die Lieb verrauscht so bald.	Sadness	Sadness

Laß rauschen, Lieb, laß rauschen,	Beauty / Joy	Sadness --- Vitality
Ich weiß nicht, wie mir wird,	Beauty / Joy	Sadness --- Vitality
Die Bächlein immer rauschen,	Beauty / Joy	Sadness --- Vitality
Und keines sich verirrt.	Beauty / Joy	Sadness --- Vitality


Zwielicht		

Dämmrung will die Flügel spreiten,	Beauty / Joy --- Uneasiness	Beauty / Joy
Schaurig rühren sich die Bäume,	Beauty / Joy --- Uneasiness	Uneasiness
Wolken ziehn wie schwere Träume -	Beauty / Joy --- Uneasiness	Uneasiness
Was will dieses Graun bedeuten?	Uneasiness	Uneasiness

Hast ein Reh du lieb vor andern,	Uneasiness	Beauty / Joy
Laß es nicht alleine grasen,	Uneasiness	Beauty / Joy
Jäger ziehn im Wald und blasen,	Uneasiness	Uneasiness
Stimmen hin und wider wandern.	Uneasiness	Uneasiness

Hast du einen Freund hienieden,	Uneasiness	Uneasiness
Trau ihm nicht zu dieser Stunde,	Uneasiness	Uneasiness
Freundlich wohl mit Aug und Munde,	Uneasiness	Uneasiness
Sinnt er Krieg im tückschen Frieden.	Uneasiness	Uneasiness

Was heut müde gehet unter,	Uneasiness --- Vitality	Vitality
Hebt sich morgen neugeboren.	Uneasiness --- Vitality	Vitality
Manches bleibt in Nacht verloren -	Uneasiness	Uneasiness
Hüte dich, bleib wach und munter!	Uneasiness	Uneasiness


Der Abend		

Schweigt der Menschen laute Lust:	Beauty / Joy	Beauty / Joy
Rauscht die Erde wie in Träumen	Beauty / Joy	Beauty / Joy
Wunderbar mit allen Bäumen,	Beauty / Joy	Beauty / Joy
Was dem Herzen kaum bewusst,	Beauty / Joy --- Sadness	Beauty / Joy
Alte Zeiten, linde Trauer,	Beauty / Joy --- Sadness	Vitality
Und es schweifen leise Schauer	Beauty / Joy --- Sadness	Vitality
Wetterleuchtend durch die Brust.	Beauty / Joy --- Sadness	Vitality


An die Geliebte		

Wenn ich, von deinem Anschaun tief gestillt,	Beauty / Joy	Beauty / Joy
Mich stumm an deinem heilgen Wert vergnüge,	Beauty / Joy	Beauty / Joy
dann hör ich recht die leisen Atemzüge	Beauty / Joy	Beauty / Joy
Des Engels, welcher sich in dir verhüllt.	Beauty / Joy	Beauty / Joy

Und ein erstaunt, ein fragend Lächeln quillt	Beauty / Joy	Beauty / Joy
Auf meinen Mund, ob mich kein Traum betrüge,	Beauty / Joy	Beauty / Joy
Daß nun in dir, zu ewiger Genüge,	Beauty / Joy	Beauty / Joy
Mein kühnster Wunsch, mein einzger, sich erfüllt?	Beauty / Joy	Beauty / Joy

Von Tiefe dann zu Tiefen stürzt mein Sinn,	Beauty / Joy	Beauty / Joy
Ich höre aus der Gottheit nächtger Ferne	Beauty / Joy	Beauty / Joy
Die Quellen des Geschicks melodisch rauschen.	Beauty / Joy	Beauty / Joy

Betäubt kehr ich den Blick nach oben hin,	Beauty / Joy	Beauty / Joy
Zum Himmel auf - da lächeln alle Sterne;	Beauty / Joy	Beauty / Joy
Ich kniee, ihrem Lichtgesang zu lauschen.	Beauty / Joy	Beauty / Joy


In der Fremde		

Ich hör die Bächlein rauschen	Vitality --- Beauty / Joy	Vitality --- Beauty / Joy
Im Walde her und hin,	Vitality --- Beauty / Joy	Vitality --- Beauty / Joy
Im Walde in dem Rauschen	Vitality --- Beauty / Joy	Vitality --- Beauty / Joy
Ich weiß nicht, wo ich bin.	Vitality --- Beauty / Joy	Vitality --- Beauty / Joy

Die Nachtigallen schlagen	Beauty / Joy	Beauty / Joy
Hier in der Einsamkeit,	Beauty / Joy	Beauty / Joy
Als wollten sie was sagen	Beauty / Joy --- Sadness	Beauty / Joy
Von der alten, schönen Zeit.	Beauty / Joy --- Sadness	Beauty / Joy

Die Mondesschimmer fliegen,	Beauty / Joy	Beauty / Joy
Als säh ich unter mir	Beauty / Joy	Beauty / Joy
Das Schloß im Tale liegen,	Beauty / Joy	Beauty / Joy
Und ist doch so weit von hier!	Beauty / Joy	Beauty / Joy

Als müßte in dem Garten,	Beauty / Joy	Beauty / Joy
Voll Rosen weiß und rot,	Beauty / Joy	Beauty / Joy
Meine Liebste auf mich warten,	Beauty / Joy	Beauty / Joy
Und ist doch lange tot.	Sadness	Sadness


Aufruf		

Reißt die Kreuze aus der Erden!	Annoyance	Annoyance --- Uneasiness
Alle sollen Schwerter werden,	Annoyance	Annoyance --- Uneasiness
Gott im Himmel wird's verzeihn.	Annoyance	Annoyance --- Uneasiness
Laßt, o laßt das Verseschweißen!	Annoyance	Annoyance --- Uneasiness
Auf den Amboß legt das Eisen!	Annoyance	Annoyance --- Uneasiness
Heiland soll das Eisen sein.	Annoyance	Annoyance --- Uneasiness

Eure Tannen, eure Eichen -	Uneasiness	Uneasiness
Habt die grünen Fragezeichen	Uneasiness	Uneasiness
Deutscher Freiheit ihr gewahrt?	Uneasiness	Uneasiness
Nein, sie soll nicht untergehen!	Uneasiness	Uneasiness
Doch ihr fröhlich Auferstehen	Uneasiness	Uneasiness
Kostet eine Höllenfahrt.	Uneasiness	Uneasiness

Deutsche, glaubet euren Sehern,	Annoyance	Annoyance
Unsre Tage werden ehern,	Annoyance	Annoyance
Unsre Zukunft klirrt in Erz;	Annoyance --- Uneasiness	Annoyance
Schwarzer Tod ist unser Sold nur,	Annoyance --- Uneasiness	Annoyance
Unser Gold ein Abendgold nur,	Annoyance --- Uneasiness	Annoyance
Unser Rot ein blutend Herz!	Annoyance --- Uneasiness	Annoyance

Reißt die Kreuze aus der Erden!	Annoyance	Annoyance --- Uneasiness
Alle sollen Schwerter werden,	Annoyance	Annoyance --- Uneasiness
Gott im Himmel wird's verzeihn.	Annoyance	Annoyance --- Uneasiness
Hört er unsre Feuer brausen	Annoyance	Annoyance --- Uneasiness
Und sein heilig Eisen sausen,	Annoyance	Annoyance --- Uneasiness
Spricht er wohl den Segen drein.	Annoyance	Annoyance --- Uneasiness

Vor der Freiheit sei kein Frieden,	Annoyance	Annoyance
Sei dem Mann kein Weib beschieden	Annoyance	Annoyance
Und kein golden Korn dem Feld;	Annoyance	Annoyance
Vor der Freiheit, vor dem Siege	Annoyance	Annoyance
Seh kein Säugling aus der Wiege	Annoyance	Annoyance
Frohen Blickes in die Welt!	Annoyance	Annoyance

In den Städten sei nur Trauern,	Uneasiness --- Annoyance	Annoyance
Bis die Freiheit von den Mauern	Uneasiness --- Annoyance	Annoyance
Schwingt die Fahnen in das Land;	Uneasiness --- Annoyance	Annoyance
Bis du, Rhein, durch freie Bogen	Uneasiness --- Annoyance	Annoyance
Donnerst, laß die letzten Wogen	Uneasiness --- Annoyance	Annoyance
Fluchend knirschen in den Sand.	Uneasiness --- Annoyance	Annoyance

Reißt die Kreuze aus der Erden!	Annoyance	Uneasiness --- Annoyance
Alle sollen Schwerter werden,	Annoyance	Uneasiness --- Annoyance
Gott im Himmel wird's verzeihn.	Annoyance	Uneasiness --- Annoyance
Gen Tyrannen und Philister!	Annoyance	Uneasiness --- Annoyance
Auch das Schwert hat seine Priester,	Annoyance	Annoyance
Und wir wollen Priester sein!	Annoyance	Annoyance


Das Lied vom Hasse		

Wohlauf, wohlauf, über Berg und Fluß	Vitality	Vitality
Dem Morgenrot entgegen,	Vitality	Vitality
Dem treuen Weib den letzten Kuß,	Vitality	Vitality
Und dann zum treuen Degen!	Vitality	Vitality
Bis unsre Hand in Asche stiebt,	Annoyance	Uneasiness
Soll sie vom Schwert nicht lassen;	Annoyance	Uneasiness
Wir haben lang genug geliebt,	Annoyance	Uneasiness
Und wollen endlich hassen!	Annoyance	Uneasiness

Die Liebe kann uns helfen nicht,	Sadness	Uneasiness --- Vitality
Die Liebe nicht erretten;	Sadness	Uneasiness --- Vitality
Halt du, o Haß, dein jüngst Gericht,	Annoyance	Uneasiness --- Vitality
Brich du, o Haß, die Ketten!	Annoyance	Uneasiness --- Vitality
Und wo es noch Tyrannen gibt,	Annoyance	Vitality
Die laßt uns keck erfassen;	Annoyance	Vitality
Wir haben lang genug geliebt,	Annoyance	Vitality
Und wollen endlich hassen!	Annoyance	Vitality

Wer noch ein Herz besitzt, dem soll's	Annoyance	Vitality
Im Hasse nur sich rühren;	Annoyance	Vitality
Allüberall ist dürres Holz,	Annoyance	Vitality
Um unsre Glut zu schüren.	Annoyance	Vitality
Die ihr der Freiheit noch verbliebt,	Annoyance	Vitality
Singt durch die deutschen Straßen:	Annoyance	Vitality
»Ihr habet lang genug geliebt,	Annoyance	Vitality
O lernet endlich hassen!«	Annoyance	Vitality

Bekämpfet sie ohn' Unterlaß,	Annoyance	Vitality
Die Tyrannei auf Erden,	Annoyance	Vitality
Und heiliger wird unser Haß ,	Annoyance	Vitality
Als unsre Liebe, werden.	Annoyance	Vitality
Bis unsre Hand in Asche stiebt,	Annoyance	Uneasiness
Soll sie vom Schwert nicht lassen;	Annoyance	Uneasiness
Wir haben lang genug geliebt,	Annoyance	Uneasiness
Und wollen endlich hassen!	Annoyance	Uneasiness


Wiegenlied		

Singet leise, leise, leise,	Beauty / Joy	Beauty / Joy --- Vitality
singt ein flüsternd Wiegenlied;	Beauty / Joy	Beauty / Joy --- Vitality
von dem Monde lernt die Weise,	Beauty / Joy	Beauty / Joy --- Vitality
der so still am Himmel zieht.	Beauty / Joy	Beauty / Joy --- Vitality

Singt ein Lied so süß gelinde,	Beauty / Joy --- Vitality	Vitality --- Beauty / Joy
wie die Quellen auf den Kieseln,	Beauty / Joy --- Vitality	Vitality --- Beauty / Joy
wie die Bienen um die Linde	Beauty / Joy --- Vitality	Vitality --- Beauty / Joy
summen, murmeln, flüstern, rieseln.	Beauty / Joy --- Vitality	Vitality --- Beauty / Joy


Nachtzauber		

Hörst du nicht die Quellen gehen	Beauty / Joy	Beauty / Joy
Zwischen Stein und Blumen weit	Beauty / Joy	Beauty / Joy
Nach den stillen Waldesseen,	Beauty / Joy	Beauty / Joy
Wo die Marmorbilder stehen	Beauty / Joy	Beauty / Joy
In der schönen Einsamkeit?	Beauty / Joy	Beauty / Joy
Von den Bergen sacht hernieder,	Beauty / Joy	Beauty / Joy
Weckend die uralten Lieder,	Beauty / Joy	Beauty / Joy
Steigt die wunderbare Nacht,	Beauty / Joy	Beauty / Joy
Und die Gründe glänzen wieder,	Beauty / Joy	Beauty / Joy
Wie dus oft im Traum gedacht.	Beauty / Joy	Beauty / Joy

Kennst die Blume du, entsprossen	Beauty / Joy	Beauty / Joy
In dem mondbeglänzten Grund?	Beauty / Joy	Beauty / Joy
Aus der Knospe, halb erschlossen,	Beauty / Joy	Beauty / Joy
Junge Glieder blühend sprossen,	Beauty / Joy	Beauty / Joy
Weiße Arme, roter Mund,	Beauty / Joy	Beauty / Joy
Und die Nachtigallen schlagen,	Beauty / Joy	Sadness
Und rings hebt es an zu klagen,	Sadness --- Beauty / Joy	Sadness
Ach, vor Liebe todeswund,	Sadness --- Beauty / Joy	Sadness
Von versunknen schönen Tagen ?	Sadness --- Beauty / Joy	Sadness
Komm, o komm zum stillen Grund!	Sadness	Sadness --- Uneasiness



